DATE_ADMINISTERED,NEW_1ST_DOSES,NEW_2ND_DOSES,NEW_SINGLE_DOSES,NEW_SERIES_COMPLETED,NEW_RECIPIENTS,CUMULATIVE_1ST_DOSES,CUMULATIVE_2ND_DOSES,CUMULATIVE_SINGLE_DOSES,CUMULATIVE_SERIES_COMPLETED,CUMULATIVE_RECIPIENTS,NEW_BOOSTER_DOSES,NEW_BOOSTER_RECIPIENTS,CUMULATIVE_BOOSTER_DOSES,CUMULATIVE_BOOSTER_RECIPIENTS,DATA_AS_OF,DATA_UPDATED_AT,DATA_LOADED_AT
2020/12/11,0,0,0,0,0,0,0,0,0,0,0,0,0,0,05/05/2022 06:00:11 AM,05/05/2022 07:36:45 AM,05/05/2022 08:15:08 AM
2020/12/12,1,1,0,1,2,1,1,0,1,2,0,0,0,0,05/05/2022 06:00:11 AM,05/05/2022 07:36:45 AM,05/05/2022 08:15:08 AM
2020/12/13,0,0,0,0,0,1,1,0,1,2,0,0,0,0,05/05/2022 06:00:11 AM,05/05/2022 07:36:45 AM,05/05/2022 08:15:08 AM
2020/12/14,1,0,0,0,1,2,1,0,1,3,0,0,0,0,05/05/2022 06:00:11 AM,05/05/2022 07:36:45 AM,05/05/2022 08:15:08 AM
2020/12/15,13,0,0,0,13,15,1,0,1,16,0,0,0,0,05/05/2022 06:00:11 AM,05/05/2022 07:36:45 AM,05/05/2022 08:15:08 AM
2020/12/16,231,0,0,0,231,246,1,0,1,247,0,0,0,0,05/05/2022 06:00:11 AM,05/05/2022 07:36:45 AM,05/05/2022 08:15:08 AM
2020/12/17,414,0,0,0,414,660,1,0,1,661,0,0,0,0,05/05/2022 06:00:11 AM,05/05/2022 07:36:45 AM,05/05/2022 08:15:08 AM
2020/12/18,920,1,0,1,921,1580,2,0,2,1582,0,0,0,0,05/05/2022 06:00:11 AM,05/05/2022 07:36:45 AM,05/05/2022 08:15:08 AM
2020/12/19,637,1,0,1,638,2217,3,0,3,2220,0,0,0,0,05/05/2022 06:00:11 AM,05/05/2022 07:36:45 AM,05/05/2022 08:15:08 AM
2020/12/20,489,2,0,2,491,2706,5,0,5,2711,0,0,0,0,05/05/2022 06:00:11 AM,05/05/2022 07:36:45 AM,05/05/2022 08:15:08 AM
2020/12/21,1177,0,0,0,1177,3883,5,0,5,3888,0,0,0,0,05/05/2022 06:00:11 AM,05/05/2022 07:36:45 AM,05/05/2022 08:15:08 AM
2020/12/22,1420,1,0,1,1421,5303,6,0,6,5309,0,0,0,0,05/05/2022 06:00:11 AM,05/05/2022 07:36:45 AM,05/05/2022 08:15:08 AM
2020/12/23,1429,5,0,5,1434,6732,11,0,11,6743,0,0,0,0,05/05/2022 06:00:11 AM,05/05/2022 07:36:45 AM,05/05/2022 08:15:08 AM
2020/12/24,869,2,0,2,871,7601,13,0,13,7614,0,0,0,0,05/05/2022 06:00:11 AM,05/05/2022 07:36:45 AM,05/05/2022 08:15:08 AM
2020/12/25,47,0,0,0,47,7648,13,0,13,7661,0,0,0,0,05/05/2022 06:00:11 AM,05/05/2022 07:36:45 AM,05/05/2022 08:15:08 AM
2020/12/26,256,0,0,0,256,7904,13,0,13,7917,0,0,0,0,05/05/2022 06:00:11 AM,05/05/2022 07:36:45 AM,05/05/2022 08:15:08 AM
2020/12/27,279,1,0,1,280,8183,14,0,14,8197,0,0,0,0,05/05/2022 06:00:11 AM,05/05/2022 07:36:45 AM,05/05/2022 08:15:08 AM
2020/12/28,1310,5,0,5,1315,9493,19,0,19,9512,0,0,0,0,05/05/2022 06:00:11 AM,05/05/2022 07:36:45 AM,05/05/2022 08:15:08 AM
2020/12/29,1420,3,0,3,1423,10913,22,0,22,10935,0,0,0,0,05/05/2022 06:00:11 AM,05/05/2022 07:36:45 AM,05/05/2022 08:15:08 AM
2020/12/30,1662,6,0,6,1668,12575,28,0,28,12603,0,0,0,0,05/05/2022 06:00:11 AM,05/05/2022 07:36:45 AM,05/05/2022 08:15:08 AM
2020/12/31,1041,0,0,0,1041,13616,28,0,28,13644,0,0,0,0,05/05/2022 06:00:11 AM,05/05/2022 07:36:45 AM,05/05/2022 08:15:08 AM
2021/01/01,92,1,0,1,93,13708,29,0,29,13737,0,0,0,0,05/05/2022 06:00:11 AM,05/05/2022 07:36:45 AM,05/05/2022 08:15:08 AM
2021/01/02,360,2,0,2,362,14068,31,0,31,14099,0,0,0,0,05/05/2022 06:00:11 AM,05/05/2022 07:36:45 AM,05/05/2022 08:15:08 AM
2021/01/03,321,0,0,0,321,14389,31,0,31,14420,0,0,0,0,05/05/2022 06:00:11 AM,05/05/2022 07:36:45 AM,05/05/2022 08:15:08 AM
2021/01/04,1874,22,0,22,1876,16263,53,0,53,16296,0,0,0,0,05/05/2022 06:00:11 AM,05/05/2022 07:36:45 AM,05/05/2022 08:15:08 AM
2021/01/05,2162,51,0,51,2164,18425,104,0,104,18460,0,0,0,0,05/05/2022 06:00:11 AM,05/05/2022 07:36:45 AM,05/05/2022 08:15:08 AM
2021/01/06,1603,272,0,272,1604,20028,376,0,376,20064,0,0,0,0,05/05/2022 06:00:11 AM,05/05/2022 07:36:45 AM,05/05/2022 08:15:08 AM
2021/01/07,1625,489,0,489,1627,21653,865,0,865,21691,0,0,0,0,05/05/2022 06:00:11 AM,05/05/2022 07:36:45 AM,05/05/2022 08:15:08 AM
2021/01/08,1523,872,0,872,1525,23176,1737,0,1737,23216,0,0,0,0,05/05/2022 06:00:11 AM,05/05/2022 07:36:45 AM,05/05/2022 08:15:08 AM
2021/01/09,926,545,0,545,929,24102,2282,0,2282,24145,0,0,0,0,05/05/2022 06:00:11 AM,05/05/2022 07:36:45 AM,05/05/2022 08:15:08 AM
2021/01/10,474,460,0,460,475,24576,2742,0,2742,24620,0,0,0,0,05/05/2022 06:00:11 AM,05/05/2022 07:36:45 AM,05/05/2022 08:15:08 AM
2021/01/11,1467,1114,0,1114,1468,26043,3856,0,3856,26088,0,0,0,0,05/05/2022 06:00:11 AM,05/05/2022 07:36:45 AM,05/05/2022 08:15:08 AM
2021/01/12,1911,1229,0,1229,1912,27954,5085,0,5085,28000,0,0,0,0,05/05/2022 06:00:11 AM,05/05/2022 07:36:45 AM,05/05/2022 08:15:08 AM
2021/01/13,2019,859,0,859,2019,29973,5944,0,5944,30019,0,0,0,0,05/05/2022 06:00:11 AM,05/05/2022 07:36:45 AM,05/05/2022 08:15:08 AM
2021/01/14,1961,559,0,559,1962,31934,6503,0,6503,31981,0,0,0,0,05/05/2022 06:00:11 AM,05/05/2022 07:36:45 AM,05/05/2022 08:15:08 AM
2021/01/15,2402,408,0,408,2406,34336,6911,0,6911,34387,0,0,0,0,05/05/2022 06:00:11 AM,05/05/2022 07:36:45 AM,05/05/2022 08:15:08 AM
2021/01/16,2094,172,0,172,2096,36430,7083,0,7083,36483,0,0,0,0,05/05/2022 06:00:11 AM,05/05/2022 07:36:45 AM,05/05/2022 08:15:08 AM
2021/01/17,1641,305,0,305,1641,38071,7388,0,7388,38124,0,0,0,0,05/05/2022 06:00:11 AM,05/05/2022 07:36:45 AM,05/05/2022 08:15:08 AM
2021/01/18,1145,282,0,282,1146,39216,7670,0,7670,39270,0,0,0,0,05/05/2022 06:00:11 AM,05/05/2022 07:36:45 AM,05/05/2022 08:15:08 AM
2021/01/19,1827,891,0,891,1828,41043,8561,0,8561,41098,0,0,0,0,05/05/2022 06:00:11 AM,05/05/2022 07:36:45 AM,05/05/2022 08:15:08 AM
2021/01/20,2133,803,0,803,2135,43176,9364,0,9364,43233,0,0,0,0,05/05/2022 06:00:11 AM,05/05/2022 07:36:45 AM,05/05/2022 08:15:08 AM
2021/01/21,2623,901,0,901,2623,45799,10265,0,10265,45856,0,0,0,0,05/05/2022 06:00:11 AM,05/05/2022 07:36:45 AM,05/05/2022 08:15:08 AM
2021/01/22,2904,513,0,513,2905,48703,10778,0,10778,48761,0,0,0,0,05/05/2022 06:00:11 AM,05/05/2022 07:36:45 AM,05/05/2022 08:15:08 AM
2021/01/23,2772,394,0,394,2773,51475,11172,0,11172,51534,0,0,0,0,05/05/2022 06:00:11 AM,05/05/2022 07:36:45 AM,05/05/2022 08:15:08 AM
2021/01/24,2204,241,0,241,2204,53679,11413,0,11413,53738,0,0,0,0,05/05/2022 06:00:11 AM,05/05/2022 07:36:45 AM,05/05/2022 08:15:08 AM
2021/01/25,3057,1598,0,1598,3059,56736,13011,0,13011,56797,0,0,0,0,05/05/2022 06:00:11 AM,05/05/2022 07:36:45 AM,05/05/2022 08:15:08 AM
2021/01/26,3192,1670,0,1670,3194,59928,14681,0,14681,59991,0,0,0,0,05/05/2022 06:00:11 AM,05/05/2022 07:36:45 AM,05/05/2022 08:15:08 AM
2021/01/27,3026,1321,0,1321,3027,62954,16002,0,16002,63018,0,0,0,0,05/05/2022 06:00:11 AM,05/05/2022 07:36:45 AM,05/05/2022 08:15:08 AM
2021/01/28,2747,1234,0,1234,2748,65701,17236,0,17236,65766,0,0,0,0,05/05/2022 06:00:11 AM,05/05/2022 07:36:45 AM,05/05/2022 08:15:08 AM
2021/01/29,3597,1337,0,1337,3597,69298,18573,0,18573,69363,0,0,0,0,05/05/2022 06:00:11 AM,05/05/2022 07:36:45 AM,05/05/2022 08:15:08 AM
2021/01/30,3333,468,0,468,3336,72631,19041,0,19041,72699,0,0,0,0,05/05/2022 06:00:11 AM,05/05/2022 07:36:45 AM,05/05/2022 08:15:08 AM
2021/01/31,2204,156,0,156,2205,74835,19197,0,19197,74904,0,0,0,0,05/05/2022 06:00:11 AM,05/05/2022 07:36:45 AM,05/05/2022 08:15:08 AM
2021/02/01,3005,1114,0,1114,3006,77840,20311,0,20311,77910,0,0,0,0,05/05/2022 06:00:11 AM,05/05/2022 07:36:45 AM,05/05/2022 08:15:08 AM
2021/02/02,3024,1597,0,1597,3025,80864,21908,0,21908,80935,0,0,0,0,05/05/2022 06:00:11 AM,05/05/2022 07:36:45 AM,05/05/2022 08:15:08 AM
2021/02/03,3866,1310,0,1310,3867,84730,23218,0,23218,84802,0,0,0,0,05/05/2022 06:00:11 AM,05/05/2022 07:36:45 AM,05/05/2022 08:15:08 AM
2021/02/04,3943,1216,0,1216,3943,88673,24434,0,24434,88745,0,0,0,0,05/05/2022 06:00:11 AM,05/05/2022 07:36:45 AM,05/05/2022 08:15:08 AM
2021/02/05,4843,1420,0,1420,4846,93516,25854,0,25854,93591,0,0,0,0,05/05/2022 06:00:11 AM,05/05/2022 07:36:45 AM,05/05/2022 08:15:08 AM
2021/02/06,4870,880,0,880,4873,98386,26734,0,26734,98464,0,0,0,0,05/05/2022 06:00:11 AM,05/05/2022 07:36:45 AM,05/05/2022 08:15:08 AM
2021/02/07,3967,584,0,584,3971,102353,27318,0,27318,102435,0,0,0,0,05/05/2022 06:00:11 AM,05/05/2022 07:36:45 AM,05/05/2022 08:15:08 AM
2021/02/08,5862,1351,0,1351,5863,108215,28669,0,28669,108298,0,0,0,0,05/05/2022 06:00:11 AM,05/05/2022 07:36:45 AM,05/05/2022 08:15:08 AM
2021/02/09,4657,1629,0,1629,4659,112872,30298,0,30298,112957,0,0,0,0,05/05/2022 06:00:11 AM,05/05/2022 07:36:45 AM,05/05/2022 08:15:08 AM
2021/02/10,5324,1943,0,1943,5329,118196,32241,0,32241,118286,0,0,0,0,05/05/2022 06:00:11 AM,05/05/2022 07:36:45 AM,05/05/2022 08:15:08 AM
2021/02/11,5180,1932,0,1932,5184,123376,34173,0,34173,123470,0,0,0,0,05/05/2022 06:00:11 AM,05/05/2022 07:36:45 AM,05/05/2022 08:15:08 AM
2021/02/12,3631,1927,0,1927,3632,127007,36100,0,36100,127102,0,0,0,0,05/05/2022 06:00:11 AM,05/05/2022 07:36:45 AM,05/05/2022 08:15:08 AM
2021/02/13,3120,1370,0,1370,3123,130127,37470,0,37470,130225,0,0,0,0,05/05/2022 06:00:11 AM,05/05/2022 07:36:45 AM,05/05/2022 08:15:08 AM
2021/02/14,2368,1178,0,1178,2370,132495,38648,0,38648,132595,0,0,0,0,05/05/2022 06:00:11 AM,05/05/2022 07:36:45 AM,05/05/2022 08:15:08 AM
2021/02/15,1694,1133,0,1133,1695,134189,39781,0,39781,134290,0,0,0,0,05/05/2022 06:00:11 AM,05/05/2022 07:36:45 AM,05/05/2022 08:15:08 AM
2021/02/16,3155,2226,0,2226,3160,137344,42007,0,42007,137450,0,0,0,0,05/05/2022 06:00:11 AM,05/05/2022 07:36:45 AM,05/05/2022 08:15:08 AM
2021/02/17,3085,2486,0,2486,3088,140429,44493,0,44493,140538,0,0,0,0,05/05/2022 06:00:11 AM,05/05/2022 07:36:45 AM,05/05/2022 08:15:08 AM
2021/02/18,2876,2728,0,2728,2881,143305,47221,0,47221,143419,0,0,0,0,05/05/2022 06:00:11 AM,05/05/2022 07:36:45 AM,05/05/2022 08:15:08 AM
2021/02/19,3059,2847,0,2847,3059,146364,50068,0,50068,146478,0,0,0,0,05/05/2022 06:00:11 AM,05/05/2022 07:36:45 AM,05/05/2022 08:15:08 AM
2021/02/20,1782,2987,0,2987,1784,148146,53055,0,53055,148262,0,0,0,0,05/05/2022 06:00:11 AM,05/05/2022 07:36:45 AM,05/05/2022 08:15:08 AM
2021/02/21,1330,1733,0,1733,1331,149476,54788,0,54788,149593,0,0,0,0,05/05/2022 06:00:11 AM,05/05/2022 07:36:45 AM,05/05/2022 08:15:08 AM
2021/02/22,2769,2800,0,2800,2772,152245,57588,0,57588,152365,0,0,0,0,05/05/2022 06:00:11 AM,05/05/2022 07:36:45 AM,05/05/2022 08:15:08 AM
2021/02/23,3062,3026,0,3026,3062,155307,60614,0,60614,155427,0,0,0,0,05/05/2022 06:00:11 AM,05/05/2022 07:36:45 AM,05/05/2022 08:15:08 AM
2021/02/24,5245,4487,0,4487,5248,160552,65101,0,65101,160675,0,0,0,0,05/05/2022 06:00:11 AM,05/05/2022 07:36:45 AM,05/05/2022 08:15:08 AM
2021/02/25,6910,3937,0,3937,6911,167462,69038,0,69038,167586,0,0,0,0,05/05/2022 06:00:11 AM,05/05/2022 07:36:45 AM,05/05/2022 08:15:08 AM
2021/02/26,7776,5568,0,5568,7780,175238,74606,0,74606,175366,0,0,0,0,05/05/2022 06:00:11 AM,05/05/2022 07:36:45 AM,05/05/2022 08:15:08 AM
2021/02/27,4892,5243,1,5244,4900,180130,79849,1,79850,180266,0,0,0,0,05/05/2022 06:00:11 AM,05/05/2022 07:36:45 AM,05/05/2022 08:15:08 AM
2021/02/28,4079,4487,1,4488,4087,184209,84336,2,84338,184353,0,0,0,0,05/05/2022 06:00:11 AM,05/05/2022 07:36:45 AM,05/05/2022 08:15:08 AM
2021/03/01,6086,6516,17,6533,6105,190295,90852,19,90871,190458,0,0,0,0,05/05/2022 06:00:11 AM,05/05/2022 07:36:45 AM,05/05/2022 08:15:08 AM
2021/03/02,6773,5407,1,5408,6776,197068,96259,20,96279,197234,0,0,0,0,05/05/2022 06:00:11 AM,05/05/2022 07:36:45 AM,05/05/2022 08:15:08 AM
2021/03/03,6711,5749,1,5750,6714,203779,102008,21,102029,203948,0,0,0,0,05/05/2022 06:00:11 AM,05/05/2022 07:36:45 AM,05/05/2022 08:15:08 AM
2021/03/04,5785,4501,2,4503,5793,209564,106509,23,106532,209741,0,0,0,0,05/05/2022 06:00:11 AM,05/05/2022 07:36:45 AM,05/05/2022 08:15:08 AM
2021/03/05,6377,4079,5,4084,6385,215941,110588,28,110616,216126,0,0,0,0,05/05/2022 06:00:11 AM,05/05/2022 07:36:45 AM,05/05/2022 08:15:08 AM
2021/03/06,4710,2792,219,3011,4929,220651,113380,247,113627,221055,0,0,0,0,05/05/2022 06:00:11 AM,05/05/2022 07:36:45 AM,05/05/2022 08:15:08 AM
2021/03/07,3487,2567,171,2738,3663,224138,115947,418,116365,224718,0,0,0,0,05/05/2022 06:00:11 AM,05/05/2022 07:36:45 AM,05/05/2022 08:15:08 AM
2021/03/08,6923,1934,233,2167,7160,231061,117881,651,118532,231878,0,0,0,0,05/05/2022 06:00:11 AM,05/05/2022 07:36:45 AM,05/05/2022 08:15:08 AM
2021/03/09,6451,2195,456,2651,6906,237512,120076,1107,121183,238784,0,0,0,0,05/05/2022 06:00:11 AM,05/05/2022 07:36:45 AM,05/05/2022 08:15:08 AM
2021/03/10,7353,4171,607,4778,7962,244865,124247,1714,125961,246746,0,0,0,0,05/05/2022 06:00:11 AM,05/05/2022 07:36:45 AM,05/05/2022 08:15:08 AM
2021/03/11,6849,2748,1086,3834,7939,251714,126995,2800,129795,254685,0,0,0,0,05/05/2022 06:00:11 AM,05/05/2022 07:36:45 AM,05/05/2022 08:15:08 AM
2021/03/12,6176,3696,1509,5205,7691,257890,130691,4309,135000,262376,0,0,0,0,05/05/2022 06:00:11 AM,05/05/2022 07:36:45 AM,05/05/2022 08:15:08 AM
2021/03/13,4249,1604,1083,2687,5332,262139,132295,5392,137687,267708,0,0,0,0,05/05/2022 06:00:11 AM,05/05/2022 07:36:45 AM,05/05/2022 08:15:08 AM
2021/03/14,3885,3395,274,3669,4163,266024,135690,5666,141356,271871,0,0,0,0,05/05/2022 06:00:11 AM,05/05/2022 07:36:45 AM,05/05/2022 08:15:08 AM
2021/03/15,8319,2946,958,3904,9277,274343,138636,6624,145260,281148,0,0,0,0,05/05/2022 06:00:11 AM,05/05/2022 07:36:45 AM,05/05/2022 08:15:08 AM
2021/03/16,8599,3267,509,3776,9113,282942,141903,7133,149036,290261,0,0,0,0,05/05/2022 06:00:11 AM,05/05/2022 07:36:45 AM,05/05/2022 08:15:08 AM
2021/03/17,9544,3509,653,4162,10200,292486,145412,7786,153198,300461,0,0,0,0,05/05/2022 06:00:11 AM,05/05/2022 07:36:45 AM,05/05/2022 08:15:08 AM
2021/03/18,5746,4067,617,4684,6361,298232,149479,8403,157882,306822,0,0,0,0,05/05/2022 06:00:11 AM,05/05/2022 07:36:45 AM,05/05/2022 08:15:08 AM
2021/03/19,6485,5838,491,6329,6982,304717,155317,8894,164211,313804,0,0,0,0,05/05/2022 06:00:11 AM,05/05/2022 07:36:45 AM,05/05/2022 08:15:08 AM
2021/03/20,5118,3447,469,3916,5591,309835,158764,9363,168127,319395,0,0,0,0,05/05/2022 06:00:11 AM,05/05/2022 07:36:45 AM,05/05/2022 08:15:08 AM
2021/03/21,3505,2942,147,3089,3653,313340,161706,9510,171216,323048,0,0,0,0,05/05/2022 06:00:11 AM,05/05/2022 07:36:45 AM,05/05/2022 08:15:08 AM
2021/03/22,5113,4220,838,5058,5954,318453,165926,10348,176274,329002,0,0,0,0,05/05/2022 06:00:11 AM,05/05/2022 07:36:45 AM,05/05/2022 08:15:08 AM
2021/03/23,5905,5082,650,5732,6554,324358,171008,10998,182006,335556,0,0,0,0,05/05/2022 06:00:11 AM,05/05/2022 07:36:45 AM,05/05/2022 08:15:08 AM
2021/03/24,5871,6076,555,6631,6430,330229,177084,11553,188637,341986,0,0,0,0,05/05/2022 06:00:11 AM,05/05/2022 07:36:45 AM,05/05/2022 08:15:08 AM
2021/03/25,5460,6181,587,6768,6047,335689,183265,12140,195405,348033,0,0,0,0,05/05/2022 06:00:11 AM,05/05/2022 07:36:45 AM,05/05/2022 08:15:08 AM
2021/03/26,5634,6431,228,6659,5862,341323,189696,12368,202064,353895,0,0,0,0,05/05/2022 06:00:11 AM,05/05/2022 07:36:45 AM,05/05/2022 08:15:08 AM
2021/03/27,3838,4952,352,5304,4196,345161,194648,12720,207368,358091,0,0,0,0,05/05/2022 06:00:11 AM,05/05/2022 07:36:45 AM,05/05/2022 08:15:08 AM
2021/03/28,2755,3910,47,3957,2802,347916,198558,12767,211325,360893,0,0,0,0,05/05/2022 06:00:11 AM,05/05/2022 07:36:45 AM,05/05/2022 08:15:08 AM
2021/03/29,4213,7428,196,7624,4412,352129,205986,12963,218949,365305,0,0,0,0,05/05/2022 06:00:11 AM,05/05/2022 07:36:45 AM,05/05/2022 08:15:08 AM
2021/03/30,5155,6594,317,6911,5477,357284,212580,13280,225860,370782,0,0,0,0,05/05/2022 06:00:11 AM,05/05/2022 07:36:45 AM,05/05/2022 08:15:08 AM
2021/03/31,4946,7442,330,7772,5273,362230,220022,13610,233632,376055,0,0,0,0,05/05/2022 06:00:11 AM,05/05/2022 07:36:45 AM,05/05/2022 08:15:08 AM
2021/04/01,5857,6855,1759,8614,7621,368087,226877,15369,242246,383676,0,0,0,0,05/05/2022 06:00:11 AM,05/05/2022 07:36:45 AM,05/05/2022 08:15:08 AM
2021/04/02,6829,6429,1902,8331,8732,374916,233306,17271,250577,392408,0,0,0,0,05/05/2022 06:00:11 AM,05/05/2022 07:36:45 AM,05/05/2022 08:15:08 AM
2021/04/03,4875,4054,1919,5973,6794,379791,237360,19190,256550,399202,0,0,0,0,05/05/2022 06:00:11 AM,05/05/2022 07:36:45 AM,05/05/2022 08:15:08 AM
2021/04/04,3400,3836,1670,5506,5078,383191,241196,20860,262056,404280,0,0,0,0,05/05/2022 06:00:11 AM,05/05/2022 07:36:45 AM,05/05/2022 08:15:08 AM
2021/04/05,5920,8431,1957,10388,7880,389111,249627,22817,272444,412160,0,0,0,0,05/05/2022 06:00:11 AM,05/05/2022 07:36:45 AM,05/05/2022 08:15:08 AM
2021/04/06,6137,8109,2140,10249,8277,395248,257736,24957,282693,420437,0,0,0,0,05/05/2022 06:00:11 AM,05/05/2022 07:36:45 AM,05/05/2022 08:15:08 AM
2021/04/07,6885,7917,2355,10272,9242,402133,265653,27312,292965,429679,0,0,0,0,05/05/2022 06:00:11 AM,05/05/2022 07:36:45 AM,05/05/2022 08:15:08 AM
2021/04/08,4711,5363,4461,9824,9170,406844,271016,31773,302789,438849,0,0,0,0,05/05/2022 06:00:11 AM,05/05/2022 07:36:45 AM,05/05/2022 08:15:08 AM
2021/04/09,6608,6033,3348,9381,9951,413452,277049,35121,312170,448800,0,0,0,0,05/05/2022 06:00:11 AM,05/05/2022 07:36:45 AM,05/05/2022 08:15:08 AM
2021/04/10,6894,4459,1867,6326,8765,420346,281508,36988,318496,457565,0,0,0,0,05/05/2022 06:00:11 AM,05/05/2022 07:36:45 AM,05/05/2022 08:15:08 AM
2021/04/11,4955,3606,1174,4780,6132,425301,285114,38162,323276,463697,0,0,0,0,05/05/2022 06:00:11 AM,05/05/2022 07:36:45 AM,05/05/2022 08:15:08 AM
2021/04/12,4894,4759,1180,5939,6087,430195,289873,39342,329215,469784,0,0,0,0,05/05/2022 06:00:11 AM,05/05/2022 07:36:45 AM,05/05/2022 08:15:08 AM
2021/04/13,5585,5536,15,5551,5607,435780,295409,39357,334766,475391,0,0,0,0,05/05/2022 06:00:11 AM,05/05/2022 07:36:45 AM,05/05/2022 08:15:08 AM
2021/04/14,6396,7148,3,7151,6411,442176,302557,39360,341917,481802,0,0,0,0,05/05/2022 06:00:11 AM,05/05/2022 07:36:45 AM,05/05/2022 08:15:08 AM
2021/04/15,8361,5907,3,5910,8376,450537,308464,39363,347827,490178,0,0,0,0,05/05/2022 06:00:11 AM,05/05/2022 07:36:45 AM,05/05/2022 08:15:08 AM
2021/04/16,7796,5601,42,5643,7842,458333,314065,39405,353470,498020,0,0,0,0,05/05/2022 06:00:11 AM,05/05/2022 07:36:45 AM,05/05/2022 08:15:08 AM
2021/04/17,7133,3183,2,3185,7141,465466,317248,39407,356655,505161,0,0,0,0,05/05/2022 06:00:11 AM,05/05/2022 07:36:45 AM,05/05/2022 08:15:08 AM
2021/04/18,4483,2661,3,2664,4493,469949,319909,39410,359319,509654,0,0,0,0,05/05/2022 06:00:11 AM,05/05/2022 07:36:45 AM,05/05/2022 08:15:08 AM
2021/04/19,6993,4167,4,4171,7010,476942,324076,39414,363490,516664,0,0,0,0,05/05/2022 06:00:11 AM,05/05/2022 07:36:45 AM,05/05/2022 08:15:08 AM
2021/04/20,8753,4460,3,4463,8764,485695,328536,39417,367953,525428,0,0,0,0,05/05/2022 06:00:11 AM,05/05/2022 07:36:45 AM,05/05/2022 08:15:08 AM
2021/04/21,7287,4915,7,4922,7320,492982,333451,39424,372875,532748,0,0,0,0,05/05/2022 06:00:11 AM,05/05/2022 07:36:45 AM,05/05/2022 08:15:08 AM
2021/04/22,6484,5074,1,5075,6501,499466,338525,39425,377950,539249,0,0,0,0,05/05/2022 06:00:11 AM,05/05/2022 07:36:45 AM,05/05/2022 08:15:08 AM
2021/04/23,6467,4700,2,4702,6494,505933,343225,39427,382652,545743,0,0,0,0,05/05/2022 06:00:11 AM,05/05/2022 07:36:45 AM,05/05/2022 08:15:08 AM
2021/04/24,4699,3502,0,3502,4730,510632,346727,39427,386154,550473,0,0,0,0,05/05/2022 06:00:11 AM,05/05/2022 07:36:45 AM,05/05/2022 08:15:08 AM
2021/04/25,2941,2135,7,2142,2961,513573,348862,39434,388296,553434,0,0,0,0,05/05/2022 06:00:11 AM,05/05/2022 07:36:45 AM,05/05/2022 08:15:08 AM
2021/04/26,4264,4422,18,4440,4322,517837,353284,39452,392736,557756,0,0,0,0,05/05/2022 06:00:11 AM,05/05/2022 07:36:45 AM,05/05/2022 08:15:08 AM
2021/04/27,4523,4672,177,4849,4719,522360,357956,39629,397585,562475,0,0,0,0,05/05/2022 06:00:11 AM,05/05/2022 07:36:45 AM,05/05/2022 08:15:08 AM
2021/04/28,5197,4896,204,5100,5427,527557,362852,39833,402685,567902,0,0,0,0,05/05/2022 06:00:11 AM,05/05/2022 07:36:45 AM,05/05/2022 08:15:08 AM
2021/04/29,4764,5133,214,5347,5007,532321,367985,40047,408032,572909,0,0,0,0,05/05/2022 06:00:11 AM,05/05/2022 07:36:45 AM,05/05/2022 08:15:08 AM
2021/04/30,4176,7155,212,7367,4412,536497,375140,40259,415399,577321,0,0,0,0,05/05/2022 06:00:11 AM,05/05/2022 07:36:45 AM,05/05/2022 08:15:08 AM
2021/05/01,1708,5282,122,5404,1859,538205,380422,40381,420803,579180,0,0,0,0,05/05/2022 06:00:11 AM,05/05/2022 07:36:45 AM,05/05/2022 08:15:08 AM
2021/05/02,986,4226,106,4332,1110,539191,384648,40487,425135,580290,0,0,0,0,05/05/2022 06:00:11 AM,05/05/2022 07:36:45 AM,05/05/2022 08:15:08 AM
2021/05/03,2238,6987,173,7160,2434,541429,391635,40660,432295,582724,0,0,0,0,05/05/2022 06:00:11 AM,05/05/2022 07:36:45 AM,05/05/2022 08:15:08 AM
2021/05/04,2236,7118,269,7387,2518,543665,398753,40929,439682,585242,0,0,0,0,05/05/2022 06:00:11 AM,05/05/2022 07:36:45 AM,05/05/2022 08:15:08 AM
2021/05/05,2288,6915,318,7233,2619,545953,405668,41247,446915,587861,0,0,0,0,05/05/2022 06:00:11 AM,05/05/2022 07:36:45 AM,05/05/2022 08:15:08 AM
2021/05/06,1883,8934,464,9398,2368,547836,414602,41711,456313,590229,0,0,0,0,05/05/2022 06:00:11 AM,05/05/2022 07:36:45 AM,05/05/2022 08:15:08 AM
2021/05/07,1690,8642,285,8927,1996,549526,423244,41996,465240,592225,0,0,0,0,05/05/2022 06:00:11 AM,05/05/2022 07:36:45 AM,05/05/2022 08:15:08 AM
2021/05/08,1090,7617,133,7750,1244,550616,430861,42129,472990,593469,0,0,0,0,05/05/2022 06:00:11 AM,05/05/2022 07:36:45 AM,05/05/2022 08:15:08 AM
2021/05/09,951,5622,89,5711,1038,551567,436483,42218,478701,594507,0,0,0,0,05/05/2022 06:00:11 AM,05/05/2022 07:36:45 AM,05/05/2022 08:15:08 AM
2021/05/10,986,6316,269,6585,1263,552553,442799,42487,485286,595770,0,0,0,0,05/05/2022 06:00:11 AM,05/05/2022 07:36:45 AM,05/05/2022 08:15:08 AM
2021/05/11,1454,6944,225,7169,1689,554007,449743,42712,492455,597459,0,0,0,0,05/05/2022 06:00:11 AM,05/05/2022 07:36:45 AM,05/05/2022 08:15:08 AM
2021/05/12,1488,6639,453,7092,1948,555495,456382,43165,499547,599407,0,0,0,0,05/05/2022 06:00:11 AM,05/05/2022 07:36:45 AM,05/05/2022 08:15:08 AM
2021/05/13,4113,7235,216,7451,4357,559608,463617,43381,506998,603764,0,0,0,0,05/05/2022 06:00:11 AM,05/05/2022 07:36:45 AM,05/05/2022 08:15:08 AM
2021/05/14,2951,6589,182,6770,3158,562559,470206,43563,513768,606922,0,0,0,0,05/05/2022 06:00:11 AM,05/05/2022 07:36:45 AM,05/05/2022 08:15:08 AM
2021/05/15,3225,4928,56,4984,3318,565784,475134,43619,518752,610240,0,0,0,0,05/05/2022 06:00:11 AM,05/05/2022 07:36:45 AM,05/05/2022 08:15:08 AM
2021/05/16,1997,3272,60,3332,2082,567781,478406,43679,522084,612322,0,0,0,0,05/05/2022 06:00:11 AM,05/05/2022 07:36:45 AM,05/05/2022 08:15:08 AM
2021/05/17,2410,4990,171,5161,2605,570191,483396,43850,527245,614927,0,0,0,0,05/05/2022 06:00:11 AM,05/05/2022 07:36:45 AM,05/05/2022 08:15:08 AM
2021/05/18,1832,6834,176,7010,2019,572023,490230,44026,534255,616946,0,0,0,0,05/05/2022 06:00:11 AM,05/05/2022 07:36:45 AM,05/05/2022 08:15:08 AM
2021/05/19,2151,5188,266,5454,2420,574174,495418,44292,539709,619366,0,0,0,0,05/05/2022 06:00:11 AM,05/05/2022 07:36:45 AM,05/05/2022 08:15:08 AM
2021/05/20,1521,4527,244,4771,1769,575695,499945,44536,544480,621135,0,0,0,0,05/05/2022 06:00:11 AM,05/05/2022 07:36:45 AM,05/05/2022 08:15:08 AM
2021/05/21,1585,5405,192,5597,1779,577280,505350,44728,550077,622914,0,0,0,0,05/05/2022 06:00:11 AM,05/05/2022 07:36:45 AM,05/05/2022 08:15:08 AM
2021/05/22,2175,2561,94,2655,2270,579455,507911,44822,552732,625184,0,0,0,0,05/05/2022 06:00:11 AM,05/05/2022 07:36:45 AM,05/05/2022 08:15:08 AM
2021/05/23,859,1047,77,1124,943,580314,508958,44899,553856,626127,0,0,0,0,05/05/2022 06:00:11 AM,05/05/2022 07:36:45 AM,05/05/2022 08:15:08 AM
2021/05/24,1342,2803,173,2976,1519,581656,511761,45072,556832,627646,0,0,0,0,05/05/2022 06:00:11 AM,05/05/2022 07:36:45 AM,05/05/2022 08:15:08 AM
2021/05/25,1111,2419,230,2649,1339,582767,514180,45302,559481,628985,0,0,0,0,05/05/2022 06:00:11 AM,05/05/2022 07:36:45 AM,05/05/2022 08:15:08 AM
2021/05/26,1106,2790,181,2971,1294,583873,516970,45483,562452,630279,0,0,0,0,05/05/2022 06:00:11 AM,05/05/2022 07:36:45 AM,05/05/2022 08:15:08 AM
2021/05/27,1163,2405,195,2600,1361,585036,519375,45678,565052,631640,0,0,0,0,05/05/2022 06:00:11 AM,05/05/2022 07:36:45 AM,05/05/2022 08:15:08 AM
2021/05/28,1323,2329,172,2501,1496,586359,521704,45850,567553,633136,0,0,0,0,05/05/2022 06:00:11 AM,05/05/2022 07:36:45 AM,05/05/2022 08:15:08 AM
2021/05/29,791,1166,94,1260,883,587150,522870,45944,568813,634019,0,0,0,0,05/05/2022 06:00:11 AM,05/05/2022 07:36:45 AM,05/05/2022 08:15:08 AM
2021/05/30,392,559,40,599,436,587542,523429,45984,569412,634455,0,0,0,0,05/05/2022 06:00:11 AM,05/05/2022 07:36:45 AM,05/05/2022 08:15:08 AM
2021/05/31,100,176,7,183,107,587642,523605,45991,569595,634562,0,0,0,0,05/05/2022 06:00:11 AM,05/05/2022 07:36:45 AM,05/05/2022 08:15:08 AM
2021/06/01,1100,2328,200,2528,1301,588742,525933,46191,572123,635863,0,0,0,0,05/05/2022 06:00:11 AM,05/05/2022 07:36:45 AM,05/05/2022 08:15:08 AM
2021/06/02,828,1569,126,1695,951,589570,527502,46317,573818,636814,0,0,0,0,05/05/2022 06:00:11 AM,05/05/2022 07:36:45 AM,05/05/2022 08:15:08 AM
2021/06/03,940,2853,187,3040,1129,590510,530355,46504,576858,637943,0,0,0,0,05/05/2022 06:00:11 AM,05/05/2022 07:36:45 AM,05/05/2022 08:15:08 AM
2021/06/04,1235,4350,147,4497,1385,591745,534705,46651,581355,639328,0,0,0,0,05/05/2022 06:00:11 AM,05/05/2022 07:36:45 AM,05/05/2022 08:15:08 AM
2021/06/05,880,2843,144,2987,1023,592625,537548,46795,584342,640351,0,0,0,0,05/05/2022 06:00:11 AM,05/05/2022 07:36:45 AM,05/05/2022 08:15:08 AM
2021/06/06,376,1891,40,1931,416,593001,539439,46835,586273,640767,0,0,0,0,05/05/2022 06:00:11 AM,05/05/2022 07:36:45 AM,05/05/2022 08:15:08 AM
2021/06/07,869,2704,149,2853,1018,593870,542143,46984,589126,641785,0,0,0,0,05/05/2022 06:00:11 AM,05/05/2022 07:36:45 AM,05/05/2022 08:15:08 AM
2021/06/08,800,1884,165,2049,961,594670,544027,47149,591175,642746,0,0,0,0,05/05/2022 06:00:11 AM,05/05/2022 07:36:45 AM,05/05/2022 08:15:08 AM
2021/06/09,665,1581,153,1734,817,595335,545608,47302,592909,643563,0,0,0,0,05/05/2022 06:00:11 AM,05/05/2022 07:36:45 AM,05/05/2022 08:15:08 AM
2021/06/10,757,1604,192,1796,952,596092,547212,47494,594705,644515,0,0,0,0,05/05/2022 06:00:11 AM,05/05/2022 07:36:45 AM,05/05/2022 08:15:08 AM
2021/06/11,924,2062,164,2226,1088,597016,549274,47658,596931,645603,0,0,0,0,05/05/2022 06:00:11 AM,05/05/2022 07:36:45 AM,05/05/2022 08:15:08 AM
2021/06/12,727,2191,167,2358,891,597743,551465,47825,599289,646494,0,0,0,0,05/05/2022 06:00:11 AM,05/05/2022 07:36:45 AM,05/05/2022 08:15:08 AM
2021/06/13,225,654,43,697,268,597968,552119,47868,599986,646762,0,0,0,0,05/05/2022 06:00:11 AM,05/05/2022 07:36:45 AM,05/05/2022 08:15:08 AM
2021/06/14,823,1562,146,1708,968,598791,553681,48014,601694,647730,0,0,0,0,05/05/2022 06:00:11 AM,05/05/2022 07:36:45 AM,05/05/2022 08:15:08 AM
2021/06/15,687,1132,131,1263,819,599478,554813,48145,602957,648549,0,0,0,0,05/05/2022 06:00:11 AM,05/05/2022 07:36:45 AM,05/05/2022 08:15:08 AM
2021/06/16,650,1059,186,1245,835,600128,555872,48331,604202,649384,0,0,0,0,05/05/2022 06:00:11 AM,05/05/2022 07:36:45 AM,05/05/2022 08:15:08 AM
2021/06/17,649,1156,192,1348,841,600777,557028,48523,605550,650225,0,0,0,0,05/05/2022 06:00:11 AM,05/05/2022 07:36:45 AM,05/05/2022 08:15:08 AM
2021/06/18,749,1434,171,1605,918,601526,558462,48694,607155,651143,0,0,0,0,05/05/2022 06:00:11 AM,05/05/2022 07:36:45 AM,05/05/2022 08:15:08 AM
2021/06/19,445,873,116,989,559,601971,559335,48810,608144,651702,0,0,0,0,05/05/2022 06:00:11 AM,05/05/2022 07:36:45 AM,05/05/2022 08:15:08 AM
2021/06/20,264,348,34,382,301,602235,559683,48844,608526,652003,0,0,0,0,05/05/2022 06:00:11 AM,05/05/2022 07:36:45 AM,05/05/2022 08:15:08 AM
2021/06/21,604,464,113,577,719,602839,560147,48957,609103,652722,0,0,0,0,05/05/2022 06:00:11 AM,05/05/2022 07:36:45 AM,05/05/2022 08:15:08 AM
2021/06/22,578,942,116,1058,692,603417,561089,49073,610161,653414,0,0,0,0,05/05/2022 06:00:11 AM,05/05/2022 07:36:45 AM,05/05/2022 08:15:08 AM
2021/06/23,584,774,135,909,716,604001,561863,49208,611070,654130,0,0,0,0,05/05/2022 06:00:11 AM,05/05/2022 07:36:45 AM,05/05/2022 08:15:08 AM
2021/06/24,521,893,170,1063,690,604522,562756,49378,612133,654820,0,0,0,0,05/05/2022 06:00:11 AM,05/05/2022 07:36:45 AM,05/05/2022 08:15:08 AM
2021/06/25,663,1082,105,1187,768,605185,563838,49483,613320,655588,0,0,0,0,05/05/2022 06:00:11 AM,05/05/2022 07:36:45 AM,05/05/2022 08:15:08 AM
2021/06/26,494,833,86,919,581,605679,564671,49569,614239,656169,0,0,0,0,05/05/2022 06:00:11 AM,05/05/2022 07:36:45 AM,05/05/2022 08:15:08 AM
2021/06/27,234,298,32,330,266,605913,564969,49601,614569,656435,0,0,0,0,05/05/2022 06:00:11 AM,05/05/2022 07:36:45 AM,05/05/2022 08:15:08 AM
2021/06/28,540,873,99,972,639,606453,565842,49700,615541,657074,0,0,0,0,05/05/2022 06:00:11 AM,05/05/2022 07:36:45 AM,05/05/2022 08:15:08 AM
2021/06/29,506,774,103,877,608,606959,566616,49803,616418,657682,0,0,0,0,05/05/2022 06:00:11 AM,05/05/2022 07:36:45 AM,05/05/2022 08:15:08 AM
2021/06/30,508,735,70,805,577,607467,567351,49873,617223,658259,0,0,0,0,05/05/2022 06:00:11 AM,05/05/2022 07:36:45 AM,05/05/2022 08:15:08 AM
2021/07/01,500,637,125,762,626,607967,567988,49998,617985,658885,0,0,0,0,05/05/2022 06:00:11 AM,05/05/2022 07:36:45 AM,05/05/2022 08:15:08 AM
2021/07/02,612,853,78,931,689,608579,568841,50076,618916,659574,0,0,0,0,05/05/2022 06:00:11 AM,05/05/2022 07:36:45 AM,05/05/2022 08:15:08 AM
2021/07/03,341,483,74,557,414,608920,569324,50150,619473,659988,0,0,0,0,05/05/2022 06:00:11 AM,05/05/2022 07:36:45 AM,05/05/2022 08:15:08 AM
2021/07/04,10,10,0,10,10,608930,569334,50150,619483,659998,0,0,0,0,05/05/2022 06:00:11 AM,05/05/2022 07:36:45 AM,05/05/2022 08:15:08 AM
2021/07/05,398,522,45,567,443,609328,569856,50195,620050,660441,0,0,0,0,05/05/2022 06:00:11 AM,05/05/2022 07:36:45 AM,05/05/2022 08:15:08 AM
2021/07/06,556,1017,94,1111,648,609884,570873,50289,621161,661089,0,0,0,0,05/05/2022 06:00:11 AM,05/05/2022 07:36:45 AM,05/05/2022 08:15:08 AM
2021/07/07,403,646,96,742,496,610287,571519,50385,621903,661585,0,0,0,0,05/05/2022 06:00:11 AM,05/05/2022 07:36:45 AM,05/05/2022 08:15:08 AM
2021/07/08,423,611,112,723,531,610710,572130,50497,622626,662116,0,0,0,0,05/05/2022 06:00:11 AM,05/05/2022 07:36:45 AM,05/05/2022 08:15:08 AM
2021/07/09,517,692,98,790,613,611227,572822,50595,623416,662729,0,0,0,0,05/05/2022 06:00:11 AM,05/05/2022 07:36:45 AM,05/05/2022 08:15:08 AM
2021/07/10,293,341,40,381,333,611520,573163,50635,623797,663062,0,0,0,0,05/05/2022 06:00:11 AM,05/05/2022 07:36:45 AM,05/05/2022 08:15:08 AM
2021/07/11,196,290,18,308,214,611716,573453,50653,624105,663276,0,0,0,0,05/05/2022 06:00:11 AM,05/05/2022 07:36:45 AM,05/05/2022 08:15:08 AM
2021/07/12,519,705,86,791,604,612235,574158,50739,624896,663880,0,0,0,0,05/05/2022 06:00:11 AM,05/05/2022 07:36:45 AM,05/05/2022 08:15:08 AM
2021/07/13,411,502,76,578,485,612646,574660,50815,625474,664365,0,0,0,0,05/05/2022 06:00:11 AM,05/05/2022 07:36:45 AM,05/05/2022 08:15:08 AM
2021/07/14,440,543,91,634,530,613086,575203,50906,626108,664895,0,0,0,0,05/05/2022 06:00:11 AM,05/05/2022 07:36:45 AM,05/05/2022 08:15:08 AM
2021/07/15,470,486,49,535,518,613556,575689,50955,626643,665413,0,0,0,0,05/05/2022 06:00:11 AM,05/05/2022 07:36:45 AM,05/05/2022 08:15:08 AM
2021/07/16,560,583,47,630,606,614116,576272,51002,627273,666019,0,0,0,0,05/05/2022 06:00:11 AM,05/05/2022 07:36:45 AM,05/05/2022 08:15:08 AM
2021/07/17,359,422,30,452,389,614475,576694,51032,627725,666408,0,0,0,0,05/05/2022 06:00:11 AM,05/05/2022 07:36:45 AM,05/05/2022 08:15:08 AM
2021/07/18,194,209,16,225,210,614669,576903,51048,627950,666618,0,0,0,0,05/05/2022 06:00:11 AM,05/05/2022 07:36:45 AM,05/05/2022 08:15:08 AM
2021/07/19,576,563,71,634,645,615245,577466,51119,628584,667263,0,0,0,0,05/05/2022 06:00:11 AM,05/05/2022 07:36:45 AM,05/05/2022 08:15:08 AM
2021/07/20,462,396,73,469,534,615707,577862,51192,629053,667797,0,0,0,0,05/05/2022 06:00:11 AM,05/05/2022 07:36:45 AM,05/05/2022 08:15:08 AM
2021/07/21,560,498,61,559,618,616267,578360,51253,629612,668415,0,0,0,0,05/05/2022 06:00:11 AM,05/05/2022 07:36:45 AM,05/05/2022 08:15:08 AM
2021/07/22,523,483,61,544,583,616790,578843,51314,630156,668998,0,0,0,0,05/05/2022 06:00:11 AM,05/05/2022 07:36:45 AM,05/05/2022 08:15:08 AM
2021/07/23,574,541,75,616,648,617364,579384,51389,630772,669646,0,0,0,0,05/05/2022 06:00:11 AM,05/05/2022 07:36:45 AM,05/05/2022 08:15:08 AM
2021/07/24,344,391,41,432,385,617708,579775,51430,631204,670031,0,0,0,0,05/05/2022 06:00:11 AM,05/05/2022 07:36:45 AM,05/05/2022 08:15:08 AM
2021/07/25,227,102,5,107,231,617935,579877,51435,631311,670262,0,0,0,0,05/05/2022 06:00:11 AM,05/05/2022 07:36:45 AM,05/05/2022 08:15:08 AM
2021/07/26,662,431,89,520,752,618597,580308,51524,631831,671014,0,0,0,0,05/05/2022 06:00:11 AM,05/05/2022 07:36:45 AM,05/05/2022 08:15:08 AM
2021/07/27,612,444,73,517,686,619209,580752,51597,632348,671700,0,0,0,0,05/05/2022 06:00:11 AM,05/05/2022 07:36:45 AM,05/05/2022 08:15:08 AM
2021/07/28,606,423,78,501,682,619815,581175,51675,632849,672382,0,0,0,0,05/05/2022 06:00:11 AM,05/05/2022 07:36:45 AM,05/05/2022 08:15:08 AM
2021/07/29,611,393,112,505,721,620426,581568,51787,633354,673103,0,0,0,0,05/05/2022 06:00:11 AM,05/05/2022 07:36:45 AM,05/05/2022 08:15:08 AM
2021/07/30,614,499,95,594,709,621040,582067,51882,633948,673812,0,0,0,0,05/05/2022 06:00:11 AM,05/05/2022 07:36:45 AM,05/05/2022 08:15:08 AM
2021/07/31,437,273,41,314,477,621477,582340,51923,634262,674289,0,0,0,0,05/05/2022 06:00:11 AM,05/05/2022 07:36:45 AM,05/05/2022 08:15:08 AM
2021/08/01,237,147,16,163,253,621714,582487,51939,634425,674542,0,0,0,0,05/05/2022 06:00:11 AM,05/05/2022 07:36:45 AM,05/05/2022 08:15:08 AM
2021/08/02,695,458,74,532,768,622409,582945,52013,634957,675310,0,0,0,0,05/05/2022 06:00:11 AM,05/05/2022 07:36:45 AM,05/05/2022 08:15:08 AM
2021/08/03,574,402,73,475,643,622983,583347,52086,635432,675953,0,0,0,0,05/05/2022 06:00:11 AM,05/05/2022 07:36:45 AM,05/05/2022 08:15:08 AM
2021/08/04,594,393,80,473,675,623577,583740,52166,635905,676628,0,0,0,0,05/05/2022 06:00:11 AM,05/05/2022 07:36:45 AM,05/05/2022 08:15:08 AM
2021/08/05,639,393,103,496,744,624216,584133,52269,636401,677372,0,0,0,0,05/05/2022 06:00:11 AM,05/05/2022 07:36:45 AM,05/05/2022 08:15:08 AM
2021/08/06,688,524,63,587,751,624904,584657,52332,636988,678123,171,171,171,171,05/05/2022 06:00:11 AM,05/05/2022 07:36:45 AM,05/05/2022 08:15:08 AM
2021/08/07,420,296,37,333,457,625324,584953,52369,637321,678580,191,191,362,362,05/05/2022 06:00:11 AM,05/05/2022 07:36:45 AM,05/05/2022 08:15:08 AM
2021/08/08,236,173,3,176,239,625560,585126,52372,637497,678819,34,34,396,396,05/05/2022 06:00:11 AM,05/05/2022 07:36:45 AM,05/05/2022 08:15:08 AM
2021/08/09,628,491,66,557,692,626188,585617,52438,638054,679511,194,194,590,590,05/05/2022 06:00:11 AM,05/05/2022 07:36:45 AM,05/05/2022 08:15:08 AM
2021/08/10,558,406,66,472,623,626746,586023,52504,638526,680134,129,129,719,719,05/05/2022 06:00:11 AM,05/05/2022 07:36:45 AM,05/05/2022 08:15:08 AM
2021/08/11,566,474,59,533,621,627312,586497,52563,639059,680755,124,124,843,843,05/05/2022 06:00:11 AM,05/05/2022 07:36:45 AM,05/05/2022 08:15:08 AM
2021/08/12,664,435,119,554,782,627976,586932,52682,639613,681537,172,172,1015,1015,05/05/2022 06:00:11 AM,05/05/2022 07:36:45 AM,05/05/2022 08:15:08 AM
2021/08/13,733,525,76,601,810,628709,587457,52758,640214,682347,245,245,1260,1260,05/05/2022 06:00:11 AM,05/05/2022 07:36:45 AM,05/05/2022 08:15:08 AM
2021/08/14,555,301,43,344,599,629264,587758,52801,640558,682946,263,263,1523,1523,05/05/2022 06:00:11 AM,05/05/2022 07:36:45 AM,05/05/2022 08:15:08 AM
2021/08/15,284,202,12,214,296,629548,587960,52813,640772,683242,166,166,1689,1689,05/05/2022 06:00:11 AM,05/05/2022 07:36:45 AM,05/05/2022 08:15:08 AM
2021/08/16,739,575,80,655,818,630287,588535,52893,641427,684060,431,431,2120,2120,05/05/2022 06:00:11 AM,05/05/2022 07:36:45 AM,05/05/2022 08:15:08 AM
2021/08/17,591,537,85,622,675,630878,589072,52978,642049,684735,516,516,2636,2636,05/05/2022 06:00:11 AM,05/05/2022 07:36:45 AM,05/05/2022 08:15:08 AM
2021/08/18,594,504,77,581,671,631472,589576,53055,642630,685406,537,537,3173,3173,05/05/2022 06:00:11 AM,05/05/2022 07:36:45 AM,05/05/2022 08:15:08 AM
2021/08/19,569,505,137,642,703,632041,590081,53192,643272,686109,560,560,3733,3733,05/05/2022 06:00:11 AM,05/05/2022 07:36:45 AM,05/05/2022 08:15:08 AM
2021/08/20,707,573,71,644,778,632748,590654,53263,643916,686887,682,682,4415,4415,05/05/2022 06:00:11 AM,05/05/2022 07:36:45 AM,05/05/2022 08:15:08 AM
2021/08/21,521,433,49,482,572,633269,591087,53312,644398,687459,359,359,4774,4774,05/05/2022 06:00:11 AM,05/05/2022 07:36:45 AM,05/05/2022 08:15:08 AM
2021/08/22,322,212,7,219,330,633591,591299,53319,644617,687789,183,183,4957,4957,05/05/2022 06:00:11 AM,05/05/2022 07:36:45 AM,05/05/2022 08:15:08 AM
2021/08/23,774,597,82,679,856,634365,591896,53401,645296,688645,608,608,5565,5565,05/05/2022 06:00:11 AM,05/05/2022 07:36:45 AM,05/05/2022 08:15:08 AM
2021/08/24,610,516,79,595,686,634975,592412,53480,645891,689331,539,539,6104,6104,05/05/2022 06:00:11 AM,05/05/2022 07:36:45 AM,05/05/2022 08:15:08 AM
2021/08/25,503,507,57,564,564,635478,592919,53537,646455,689895,473,473,6577,6577,05/05/2022 06:00:11 AM,05/05/2022 07:36:45 AM,05/05/2022 08:15:08 AM
2021/08/26,586,556,110,666,693,636064,593475,53647,647121,690588,559,558,7136,7135,05/05/2022 06:00:11 AM,05/05/2022 07:36:45 AM,05/05/2022 08:15:08 AM
2021/08/27,588,605,57,662,645,636652,594080,53704,647783,691233,583,578,7719,7713,05/05/2022 06:00:11 AM,05/05/2022 07:36:45 AM,05/05/2022 08:15:08 AM
2021/08/28,430,429,53,482,484,637082,594509,53757,648265,691717,336,330,8055,8043,05/05/2022 06:00:11 AM,05/05/2022 07:36:45 AM,05/05/2022 08:15:08 AM
2021/08/29,207,217,2,219,209,637289,594726,53759,648484,691926,181,178,8236,8221,05/05/2022 06:00:11 AM,05/05/2022 07:36:45 AM,05/05/2022 08:15:08 AM
2021/08/30,570,562,61,623,631,637859,595288,53820,649107,692557,525,522,8761,8743,05/05/2022 06:00:11 AM,05/05/2022 07:36:45 AM,05/05/2022 08:15:08 AM
2021/08/31,461,484,58,542,521,638320,595772,53878,649649,693078,651,650,9412,9393,05/05/2022 06:00:11 AM,05/05/2022 07:36:45 AM,05/05/2022 08:15:08 AM
2021/09/01,457,481,47,528,504,638777,596253,53925,650177,693582,543,539,9955,9932,05/05/2022 06:00:11 AM,05/05/2022 07:36:45 AM,05/05/2022 08:15:08 AM
2021/09/02,411,502,105,607,518,639188,596755,54030,650784,694100,518,514,10473,10446,05/05/2022 06:00:11 AM,05/05/2022 07:36:45 AM,05/05/2022 08:15:08 AM
2021/09/03,499,619,58,677,557,639687,597374,54088,651461,694657,546,537,11019,10983,05/05/2022 06:00:11 AM,05/05/2022 07:36:45 AM,05/05/2022 08:15:08 AM
2021/09/04,334,490,34,524,368,640021,597864,54122,651985,695025,242,241,11261,11224,05/05/2022 06:00:11 AM,05/05/2022 07:36:45 AM,05/05/2022 08:15:08 AM
2021/09/05,183,211,5,216,189,640204,598075,54127,652201,695214,162,160,11423,11384,05/05/2022 06:00:11 AM,05/05/2022 07:36:45 AM,05/05/2022 08:15:08 AM
2021/09/06,71,62,0,62,71,640275,598137,54127,652263,695285,25,23,11448,11407,05/05/2022 06:00:11 AM,05/05/2022 07:36:45 AM,05/05/2022 08:15:08 AM
2021/09/07,418,756,49,805,469,640693,598893,54176,653068,695754,539,531,11987,11938,05/05/2022 06:00:11 AM,05/05/2022 07:36:45 AM,05/05/2022 08:15:08 AM
2021/09/08,367,543,39,582,405,641060,599436,54215,653650,696159,434,420,12421,12358,05/05/2022 06:00:11 AM,05/05/2022 07:36:45 AM,05/05/2022 08:15:08 AM
2021/09/09,381,466,100,566,477,641441,599902,54315,654216,696636,390,383,12811,12741,05/05/2022 06:00:11 AM,05/05/2022 07:36:45 AM,05/05/2022 08:15:08 AM
2021/09/10,383,641,40,681,423,641824,600543,54355,654897,697059,436,427,13247,13168,05/05/2022 06:00:11 AM,05/05/2022 07:36:45 AM,05/05/2022 08:15:08 AM
2021/09/11,270,438,39,477,308,642094,600981,54394,655374,697367,207,202,13454,13370,05/05/2022 06:00:11 AM,05/05/2022 07:36:45 AM,05/05/2022 08:15:08 AM
2021/09/12,166,275,3,278,169,642260,601256,54397,655652,697536,131,127,13585,13497,05/05/2022 06:00:11 AM,05/05/2022 07:36:45 AM,05/05/2022 08:15:08 AM
2021/09/13,354,646,30,676,382,642614,601902,54427,656328,697918,361,353,13946,13850,05/05/2022 06:00:11 AM,05/05/2022 07:36:45 AM,05/05/2022 08:15:08 AM
2021/09/14,325,530,54,584,381,642939,602432,54481,656912,698299,358,352,14304,14202,05/05/2022 06:00:11 AM,05/05/2022 07:36:45 AM,05/05/2022 08:15:08 AM
2021/09/15,362,457,42,499,407,643301,602889,54523,657411,698706,352,343,14656,14545,05/05/2022 06:00:11 AM,05/05/2022 07:36:45 AM,05/05/2022 08:15:08 AM
2021/09/16,334,490,80,570,414,643635,603379,54603,657981,699120,321,316,14977,14861,05/05/2022 06:00:11 AM,05/05/2022 07:36:45 AM,05/05/2022 08:15:08 AM
2021/09/17,301,569,36,605,338,643936,603948,54639,658586,699458,373,367,15350,15228,05/05/2022 06:00:11 AM,05/05/2022 07:36:45 AM,05/05/2022 08:15:08 AM
2021/09/18,240,368,35,403,275,644176,604316,54674,658989,699733,222,215,15572,15443,05/05/2022 06:00:11 AM,05/05/2022 07:36:45 AM,05/05/2022 08:15:08 AM
2021/09/19,132,202,5,207,137,644308,604518,54679,659196,699870,138,135,15710,15578,05/05/2022 06:00:11 AM,05/05/2022 07:36:45 AM,05/05/2022 08:15:08 AM
2021/09/20,319,478,30,508,349,644627,604996,54709,659704,700219,382,378,16092,15956,05/05/2022 06:00:11 AM,05/05/2022 07:36:45 AM,05/05/2022 08:15:08 AM
2021/09/21,268,370,63,433,330,644895,605366,54772,660137,700549,323,314,16415,16270,05/05/2022 06:00:11 AM,05/05/2022 07:36:45 AM,05/05/2022 08:15:08 AM
2021/09/22,271,355,27,382,298,645166,605721,54799,660519,700847,284,277,16699,16547,05/05/2022 06:00:11 AM,05/05/2022 07:36:45 AM,05/05/2022 08:15:08 AM
2021/09/23,272,372,71,443,341,645438,606093,54870,660962,701188,375,366,17074,16913,05/05/2022 06:00:11 AM,05/05/2022 07:36:45 AM,05/05/2022 08:15:08 AM
2021/09/24,321,472,41,513,366,645759,606565,54911,661475,701554,852,848,17926,17761,05/05/2022 06:00:11 AM,05/05/2022 07:36:45 AM,05/05/2022 08:15:08 AM
2021/09/25,275,336,35,371,311,646034,606901,54946,661846,701865,970,967,18896,18728,05/05/2022 06:00:11 AM,05/05/2022 07:36:45 AM,05/05/2022 08:15:08 AM
2021/09/26,169,174,6,180,175,646203,607075,54952,662026,702040,762,759,19658,19487,05/05/2022 06:00:11 AM,05/05/2022 07:36:45 AM,05/05/2022 08:15:08 AM
2021/09/27,357,286,52,338,410,646560,607361,55004,662364,702450,2147,2142,21805,21629,05/05/2022 06:00:11 AM,05/05/2022 07:36:45 AM,05/05/2022 08:15:08 AM
2021/09/28,310,397,53,450,362,646870,607758,55057,662814,702812,2014,2010,23819,23639,05/05/2022 06:00:11 AM,05/05/2022 07:36:45 AM,05/05/2022 08:15:08 AM
2021/09/29,317,380,89,469,405,647187,608138,55146,663283,703217,2120,2113,25939,25752,05/05/2022 06:00:11 AM,05/05/2022 07:36:45 AM,05/05/2022 08:15:08 AM
2021/09/30,311,364,75,439,386,647498,608502,55221,663722,703603,2129,2120,28068,27872,05/05/2022 06:00:11 AM,05/05/2022 07:36:45 AM,05/05/2022 08:15:08 AM
2021/10/01,311,436,40,476,350,647809,608938,55261,664198,703953,2438,2431,30506,30303,05/05/2022 06:00:11 AM,05/05/2022 07:36:45 AM,05/05/2022 08:15:08 AM
2021/10/02,196,232,27,259,225,648005,609170,55288,664457,704178,943,941,31449,31244,05/05/2022 06:00:11 AM,05/05/2022 07:36:45 AM,05/05/2022 08:15:08 AM
2021/10/03,134,162,5,167,139,648139,609332,55293,664624,704317,670,665,32119,31909,05/05/2022 06:00:11 AM,05/05/2022 07:36:45 AM,05/05/2022 08:15:08 AM
2021/10/04,354,308,37,345,393,648493,609640,55330,664969,704710,2224,2220,34343,34129,05/05/2022 06:00:11 AM,05/05/2022 07:36:45 AM,05/05/2022 08:15:08 AM
2021/10/05,348,324,53,377,402,648841,609964,55383,665346,705112,2330,2320,36673,36449,05/05/2022 06:00:11 AM,05/05/2022 07:36:45 AM,05/05/2022 08:15:08 AM
2021/10/06,268,308,30,338,300,649109,610272,55413,665684,705412,2213,2207,38886,38656,05/05/2022 06:00:11 AM,05/05/2022 07:36:45 AM,05/05/2022 08:15:08 AM
2021/10/07,295,289,57,346,353,649404,610561,55470,666030,705765,2144,2141,41030,40797,05/05/2022 06:00:11 AM,05/05/2022 07:36:45 AM,05/05/2022 08:15:08 AM
2021/10/08,304,313,49,362,355,649708,610874,55519,666392,706120,2507,2502,43537,43299,05/05/2022 06:00:11 AM,05/05/2022 07:36:45 AM,05/05/2022 08:15:08 AM
2021/10/09,208,202,26,228,235,649916,611076,55545,666620,706355,1064,1061,44601,44360,05/05/2022 06:00:11 AM,05/05/2022 07:36:45 AM,05/05/2022 08:15:08 AM
2021/10/10,123,127,5,132,129,650039,611203,55550,666752,706484,689,683,45290,45043,05/05/2022 06:00:11 AM,05/05/2022 07:36:45 AM,05/05/2022 08:15:08 AM
2021/10/11,314,242,25,267,338,650353,611445,55575,667019,706822,2364,2361,47654,47404,05/05/2022 06:00:11 AM,05/05/2022 07:36:45 AM,05/05/2022 08:15:08 AM
2021/10/12,311,310,59,369,371,650664,611755,55634,667388,707193,2698,2692,50352,50096,05/05/2022 06:00:11 AM,05/05/2022 07:36:45 AM,05/05/2022 08:15:08 AM
2021/10/13,298,296,43,339,344,650962,612051,55677,667727,707537,2410,2402,52762,52498,05/05/2022 06:00:11 AM,05/05/2022 07:36:45 AM,05/05/2022 08:15:08 AM
2021/10/14,268,255,68,323,338,651230,612306,55745,668050,707875,2130,2121,54892,54619,05/05/2022 06:00:11 AM,05/05/2022 07:36:45 AM,05/05/2022 08:15:08 AM
2021/10/15,314,359,40,399,355,651544,612665,55785,668449,708230,2728,2721,57620,57340,05/05/2022 06:00:11 AM,05/05/2022 07:36:45 AM,05/05/2022 08:15:08 AM
2021/10/16,158,170,38,208,196,651702,612835,55823,668657,708426,1065,1062,58685,58402,05/05/2022 06:00:11 AM,05/05/2022 07:36:45 AM,05/05/2022 08:15:08 AM
2021/10/17,95,109,4,113,100,651797,612944,55827,668770,708526,635,635,59320,59037,05/05/2022 06:00:11 AM,05/05/2022 07:36:45 AM,05/05/2022 08:15:08 AM
2021/10/18,290,319,64,383,355,652087,613263,55891,669153,708881,2368,2357,61688,61394,05/05/2022 06:00:11 AM,05/05/2022 07:36:45 AM,05/05/2022 08:15:08 AM
2021/10/19,288,263,36,299,325,652375,613526,55927,669452,709206,2520,2513,64208,63907,05/05/2022 06:00:11 AM,05/05/2022 07:36:45 AM,05/05/2022 08:15:08 AM
2021/10/20,255,266,12,278,266,652630,613792,55939,669730,709472,2291,2289,66499,66196,05/05/2022 06:00:11 AM,05/05/2022 07:36:45 AM,05/05/2022 08:15:08 AM
2021/10/21,253,239,47,286,300,652883,614031,55986,670016,709772,2088,2077,68587,68273,05/05/2022 06:00:11 AM,05/05/2022 07:36:45 AM,05/05/2022 08:15:08 AM
2021/10/22,315,271,44,315,362,653198,614302,56030,670331,710134,3609,3605,72196,71878,05/05/2022 06:00:11 AM,05/05/2022 07:36:45 AM,05/05/2022 08:15:08 AM
2021/10/23,218,157,21,178,240,653416,614459,56051,670509,710374,1416,1409,73612,73287,05/05/2022 06:00:11 AM,05/05/2022 07:36:45 AM,05/05/2022 08:15:08 AM
2021/10/24,88,74,3,77,93,653504,614533,56054,670586,710467,765,761,74377,74048,05/05/2022 06:00:11 AM,05/05/2022 07:36:45 AM,05/05/2022 08:15:08 AM
2021/10/25,363,313,32,345,401,653867,614846,56086,670931,710868,3438,3434,77815,77482,05/05/2022 06:00:11 AM,05/05/2022 07:36:45 AM,05/05/2022 08:15:08 AM
2021/10/26,331,310,36,346,371,654198,615156,56122,671277,711239,3826,3824,81641,81306,05/05/2022 06:00:11 AM,05/05/2022 07:36:45 AM,05/05/2022 08:15:08 AM
2021/10/27,355,270,21,291,380,654553,615426,56143,671568,711619,3977,3966,85618,85272,05/05/2022 06:00:11 AM,05/05/2022 07:36:45 AM,05/05/2022 08:15:08 AM
2021/10/28,324,271,34,305,365,654877,615697,56177,671873,711984,4116,4111,89734,89383,05/05/2022 06:00:11 AM,05/05/2022 07:36:45 AM,05/05/2022 08:15:08 AM
2021/10/29,381,313,43,356,432,655258,616010,56220,672229,712416,5205,5196,94939,94579,05/05/2022 06:00:11 AM,05/05/2022 07:36:45 AM,05/05/2022 08:15:08 AM
2021/10/30,210,176,34,210,247,655468,616186,56254,672439,712663,1967,1960,96906,96539,05/05/2022 06:00:11 AM,05/05/2022 07:36:45 AM,05/05/2022 08:15:08 AM
2021/10/31,149,109,5,114,155,655617,616295,56259,672553,712818,1121,1118,98027,97657,05/05/2022 06:00:11 AM,05/05/2022 07:36:45 AM,05/05/2022 08:15:08 AM
2021/11/01,438,308,45,353,489,656055,616603,56304,672906,713307,4518,4513,102545,102170,05/05/2022 06:00:11 AM,05/05/2022 07:36:45 AM,05/05/2022 08:15:08 AM
2021/11/02,408,306,40,346,447,656463,616909,56344,673252,713754,5061,5051,107606,107221,05/05/2022 06:00:11 AM,05/05/2022 07:36:45 AM,05/05/2022 08:15:08 AM
2021/11/03,412,284,32,316,447,656875,617193,56376,673568,714201,4749,4738,112355,111959,05/05/2022 06:00:11 AM,05/05/2022 07:36:45 AM,05/05/2022 08:15:08 AM
2021/11/04,494,261,35,296,533,657369,617454,56411,673864,714734,4943,4933,117298,116892,05/05/2022 06:00:11 AM,05/05/2022 07:36:45 AM,05/05/2022 08:15:08 AM
2021/11/05,1238,359,51,410,1301,658607,617813,56462,674274,716035,6069,6059,123367,122951,05/05/2022 06:00:11 AM,05/05/2022 07:36:45 AM,05/05/2022 08:15:08 AM
2021/11/06,1738,163,26,189,1769,660345,617976,56488,674463,717804,2411,2403,125778,125354,05/05/2022 06:00:11 AM,05/05/2022 07:36:45 AM,05/05/2022 08:15:08 AM
2021/11/07,961,92,5,97,972,661306,618068,56493,674560,718776,1230,1227,127008,126581,05/05/2022 06:00:11 AM,05/05/2022 07:36:45 AM,05/05/2022 08:15:08 AM
2021/11/08,1756,268,40,308,1796,663062,618336,56533,674868,720572,5026,5014,132034,131595,05/05/2022 06:00:11 AM,05/05/2022 07:36:45 AM,05/05/2022 08:15:08 AM
2021/11/09,1720,275,33,308,1756,664782,618611,56566,675176,722328,4582,4568,136616,136163,05/05/2022 06:00:11 AM,05/05/2022 07:36:45 AM,05/05/2022 08:15:08 AM
2021/11/10,1639,272,22,294,1666,666421,618883,56588,675470,723994,4795,4783,141411,140946,05/05/2022 06:00:11 AM,05/05/2022 07:36:45 AM,05/05/2022 08:15:08 AM
2021/11/11,1628,194,14,208,1645,668049,619077,56602,675678,725639,4306,4298,145717,145244,05/05/2022 06:00:11 AM,05/05/2022 07:36:45 AM,05/05/2022 08:15:08 AM
2021/11/12,1625,290,28,318,1657,669674,619367,56630,675996,727296,5704,5694,151421,150938,05/05/2022 06:00:11 AM,05/05/2022 07:36:45 AM,05/05/2022 08:15:08 AM
2021/11/13,2379,138,19,157,2401,672053,619505,56649,676153,729697,2853,2849,154274,153787,05/05/2022 06:00:11 AM,05/05/2022 07:36:45 AM,05/05/2022 08:15:08 AM
2021/11/14,760,68,2,70,767,672813,619573,56651,676223,730464,1512,1509,155786,155296,05/05/2022 06:00:11 AM,05/05/2022 07:36:45 AM,05/05/2022 08:15:08 AM
2021/11/15,1184,328,34,362,1222,673997,619901,56685,676585,731686,5745,5731,161531,161027,05/05/2022 06:00:11 AM,05/05/2022 07:36:45 AM,05/05/2022 08:15:08 AM
2021/11/16,1264,312,33,345,1304,675261,620213,56718,676930,732990,6096,6084,167627,167111,05/05/2022 06:00:11 AM,05/05/2022 07:36:45 AM,05/05/2022 08:15:08 AM
2021/11/17,1359,304,27,331,1394,676620,620517,56745,677261,734384,6171,6156,173798,173267,05/05/2022 06:00:11 AM,05/05/2022 07:36:45 AM,05/05/2022 08:15:08 AM
2021/11/18,1154,321,19,340,1183,677774,620838,56764,677601,735567,6339,6321,180137,179588,05/05/2022 06:00:11 AM,05/05/2022 07:36:45 AM,05/05/2022 08:15:08 AM
2021/11/19,1282,314,33,347,1319,679056,621152,56797,677948,736886,7406,7392,187543,186980,05/05/2022 06:00:11 AM,05/05/2022 07:36:45 AM,05/05/2022 08:15:08 AM
2021/11/20,1278,177,11,188,1293,680334,621329,56808,678136,738179,3552,3543,191095,190523,05/05/2022 06:00:11 AM,05/05/2022 07:36:45 AM,05/05/2022 08:15:08 AM
2021/11/21,496,114,3,117,502,680830,621443,56811,678253,738681,1621,1615,192716,192138,05/05/2022 06:00:11 AM,05/05/2022 07:36:45 AM,05/05/2022 08:15:08 AM
2021/11/22,1492,336,29,365,1534,682322,621779,56840,678618,740215,7204,7189,199920,199327,05/05/2022 06:00:11 AM,05/05/2022 07:36:45 AM,05/05/2022 08:15:08 AM
2021/11/23,1234,351,35,386,1291,683556,622130,56875,679004,741506,7117,7100,207037,206427,05/05/2022 06:00:11 AM,05/05/2022 07:36:45 AM,05/05/2022 08:15:08 AM
2021/11/24,1055,315,25,340,1091,684611,622445,56900,679344,742597,5905,5885,212942,212312,05/05/2022 06:00:11 AM,05/05/2022 07:36:45 AM,05/05/2022 08:15:08 AM
2021/11/25,67,72,4,76,71,684678,622517,56904,679420,742668,333,331,213275,212643,05/05/2022 06:00:11 AM,05/05/2022 07:36:45 AM,05/05/2022 08:15:08 AM
2021/11/26,420,273,4,277,432,685098,622790,56908,679697,743100,3248,3240,216523,215883,05/05/2022 06:00:11 AM,05/05/2022 07:36:45 AM,05/05/2022 08:15:08 AM
2021/11/27,511,1030,8,1038,521,685609,623820,56916,680735,743621,2499,2489,219022,218372,05/05/2022 06:00:11 AM,05/05/2022 07:36:45 AM,05/05/2022 08:15:08 AM
2021/11/28,289,1110,10,1120,301,685898,624930,56926,681855,743922,1492,1491,220514,219863,05/05/2022 06:00:11 AM,05/05/2022 07:36:45 AM,05/05/2022 08:15:08 AM
2021/11/29,778,1330,33,1363,818,686676,626260,56959,683218,744740,6263,6246,226777,226109,05/05/2022 06:00:11 AM,05/05/2022 07:36:45 AM,05/05/2022 08:15:08 AM
2021/11/30,753,1536,37,1573,799,687429,627796,56996,684791,745539,6612,6592,233389,232701,05/05/2022 06:00:11 AM,05/05/2022 07:36:45 AM,05/05/2022 08:15:08 AM
2021/12/01,839,1416,28,1444,875,688268,629212,57024,686235,746414,7031,7014,240420,239715,05/05/2022 06:00:11 AM,05/05/2022 07:36:45 AM,05/05/2022 08:15:08 AM
2021/12/02,815,1529,34,1563,854,689083,630741,57058,687798,747268,7121,7107,247541,246822,05/05/2022 06:00:11 AM,05/05/2022 07:36:45 AM,05/05/2022 08:15:08 AM
2021/12/03,842,1754,20,1774,867,689925,632495,57078,689572,748135,7493,7477,255034,254299,05/05/2022 06:00:11 AM,05/05/2022 07:36:45 AM,05/05/2022 08:15:08 AM
2021/12/04,731,2228,16,2244,750,690656,634723,57094,691816,748885,3714,3698,258748,257997,05/05/2022 06:00:11 AM,05/05/2022 07:36:45 AM,05/05/2022 08:15:08 AM
2021/12/05,314,578,2,580,317,690970,635301,57096,692396,749202,1641,1641,260389,259638,05/05/2022 06:00:11 AM,05/05/2022 07:36:45 AM,05/05/2022 08:15:08 AM
2021/12/06,830,1154,29,1183,868,691800,636455,57125,693579,750070,6963,6945,267352,266583,05/05/2022 06:00:11 AM,05/05/2022 07:36:45 AM,05/05/2022 08:15:08 AM
2021/12/07,949,1103,25,1128,983,692749,637558,57150,694707,751053,7317,7301,274669,273884,05/05/2022 06:00:11 AM,05/05/2022 07:36:45 AM,05/05/2022 08:15:08 AM
2021/12/08,906,1210,30,1240,939,693655,638768,57180,695947,751992,7181,7169,281850,281053,05/05/2022 06:00:11 AM,05/05/2022 07:36:45 AM,05/05/2022 08:15:08 AM
2021/12/09,808,959,33,992,845,694463,639727,57213,696939,752837,6696,6680,288546,287733,05/05/2022 06:00:11 AM,05/05/2022 07:36:45 AM,05/05/2022 08:15:08 AM
2021/12/10,872,1104,26,1130,906,695335,640831,57239,698069,753743,7265,7253,295811,294986,05/05/2022 06:00:11 AM,05/05/2022 07:36:45 AM,05/05/2022 08:15:08 AM
2021/12/11,651,1318,22,1340,673,695986,642149,57261,699409,754416,3389,3379,299200,298365,05/05/2022 06:00:11 AM,05/05/2022 07:36:45 AM,05/05/2022 08:15:08 AM
2021/12/12,279,385,1,386,281,696265,642534,57262,699795,754697,1514,1511,300714,299876,05/05/2022 06:00:11 AM,05/05/2022 07:36:45 AM,05/05/2022 08:15:08 AM
2021/12/13,687,957,15,972,707,696952,643491,57277,700767,755404,5931,5913,306645,305789,05/05/2022 06:00:11 AM,05/05/2022 07:36:45 AM,05/05/2022 08:15:08 AM
2021/12/14,807,877,24,901,834,697759,644368,57301,701668,756238,6418,6403,313063,312192,05/05/2022 06:00:11 AM,05/05/2022 07:36:45 AM,05/05/2022 08:15:08 AM
2021/12/15,721,889,26,915,757,698480,645257,57327,702583,756995,6274,6256,319337,318448,05/05/2022 06:00:11 AM,05/05/2022 07:36:45 AM,05/05/2022 08:15:08 AM
2021/12/16,786,527,23,550,817,699266,645784,57350,703133,757812,6631,6613,325968,325061,05/05/2022 06:00:11 AM,05/05/2022 07:36:45 AM,05/05/2022 08:15:08 AM
2021/12/17,859,692,13,705,876,700125,646476,57363,703838,758688,6927,6897,332895,331958,05/05/2022 06:00:11 AM,05/05/2022 07:36:45 AM,05/05/2022 08:15:08 AM
2021/12/18,703,634,13,647,718,700828,647110,57376,704485,759406,3782,3760,336677,335718,05/05/2022 06:00:11 AM,05/05/2022 07:36:45 AM,05/05/2022 08:15:08 AM
2021/12/19,379,243,1,244,384,701207,647353,57377,704729,759790,2069,2065,338746,337783,05/05/2022 06:00:11 AM,05/05/2022 07:36:45 AM,05/05/2022 08:15:08 AM
2021/12/20,916,678,12,690,935,702123,648031,57389,705419,760725,6780,6755,345526,344538,05/05/2022 06:00:11 AM,05/05/2022 07:36:45 AM,05/05/2022 08:15:08 AM
2021/12/21,980,612,17,629,1008,703103,648643,57406,706048,761733,6778,6754,352304,351292,05/05/2022 06:00:11 AM,05/05/2022 07:36:45 AM,05/05/2022 08:15:08 AM
2021/12/22,856,610,15,625,882,703959,649253,57421,706673,762615,6689,6657,358993,357949,05/05/2022 06:00:11 AM,05/05/2022 07:36:45 AM,05/05/2022 08:15:08 AM
2021/12/23,791,439,13,452,815,704750,649692,57434,707125,763430,5735,5713,364728,363662,05/05/2022 06:00:11 AM,05/05/2022 07:36:45 AM,05/05/2022 08:15:08 AM
2021/12/24,202,134,7,141,210,704952,649826,57441,707266,763640,1684,1677,366412,365339,05/05/2022 06:00:11 AM,05/05/2022 07:36:45 AM,05/05/2022 08:15:08 AM
2021/12/25,1,0,0,0,1,704953,649826,57441,707266,763641,6,6,366418,365345,05/05/2022 06:00:11 AM,05/05/2022 07:36:45 AM,05/05/2022 08:15:08 AM
2021/12/26,206,156,1,157,208,705159,649982,57442,707423,763849,1006,996,367424,366341,05/05/2022 06:00:11 AM,05/05/2022 07:36:45 AM,05/05/2022 08:15:08 AM
2021/12/27,791,689,7,696,806,705950,650671,57449,708119,764655,5208,5184,372632,371525,05/05/2022 06:00:11 AM,05/05/2022 07:36:45 AM,05/05/2022 08:15:08 AM
2021/12/28,783,589,13,602,805,706733,651260,57462,708721,765460,5488,5442,378120,376967,05/05/2022 06:00:11 AM,05/05/2022 07:36:45 AM,05/05/2022 08:15:08 AM
2021/12/29,804,511,11,522,818,707537,651771,57473,709243,766278,5326,5303,383446,382270,05/05/2022 06:00:11 AM,05/05/2022 07:36:45 AM,05/05/2022 08:15:08 AM
2021/12/30,793,515,11,526,807,708330,652286,57484,709769,767085,5108,5074,388554,387344,05/05/2022 06:00:11 AM,05/05/2022 07:36:45 AM,05/05/2022 08:15:08 AM
2021/12/31,255,186,6,192,261,708585,652472,57490,709961,767346,1877,1863,390431,389207,05/05/2022 06:00:11 AM,05/05/2022 07:36:45 AM,05/05/2022 08:15:08 AM
2022/01/01,10,41,0,41,10,708595,652513,57490,710002,767356,29,29,390460,389236,05/05/2022 06:00:11 AM,05/05/2022 07:36:45 AM,05/05/2022 08:15:08 AM
2022/01/02,176,244,2,246,178,708771,652757,57492,710248,767534,955,944,391415,390180,05/05/2022 06:00:11 AM,05/05/2022 07:36:45 AM,05/05/2022 08:15:08 AM
2022/01/03,673,548,15,563,693,709444,653305,57507,710811,768227,4281,4248,395696,394428,05/05/2022 06:00:11 AM,05/05/2022 07:36:45 AM,05/05/2022 08:15:08 AM
2022/01/04,589,474,16,490,610,710033,653779,57523,711301,768837,4563,4537,400259,398965,05/05/2022 06:00:11 AM,05/05/2022 07:36:45 AM,05/05/2022 08:15:08 AM
2022/01/05,736,477,7,484,748,710769,654256,57530,711785,769585,4387,4346,404646,403311,05/05/2022 06:00:11 AM,05/05/2022 07:36:45 AM,05/05/2022 08:15:08 AM
2022/01/06,755,540,12,552,770,711524,654796,57542,712337,770355,4756,4724,409402,408035,05/05/2022 06:00:11 AM,05/05/2022 07:36:45 AM,05/05/2022 08:15:08 AM
2022/01/07,763,585,11,596,777,712287,655381,57553,712933,771132,5528,5484,414930,413519,05/05/2022 06:00:11 AM,05/05/2022 07:36:45 AM,05/05/2022 08:15:08 AM
2022/01/08,510,524,6,530,516,712797,655905,57559,713463,771648,3052,3032,417982,416551,05/05/2022 06:00:11 AM,05/05/2022 07:36:45 AM,05/05/2022 08:15:08 AM
2022/01/09,214,167,0,167,217,713011,656072,57559,713630,771865,1073,1063,419055,417614,05/05/2022 06:00:11 AM,05/05/2022 07:36:45 AM,05/05/2022 08:15:08 AM
2022/01/10,615,429,7,436,630,713626,656501,57566,714066,772495,4403,4370,423458,421984,05/05/2022 06:00:11 AM,05/05/2022 07:36:45 AM,05/05/2022 08:15:08 AM
2022/01/11,685,453,18,471,704,714311,656954,57584,714537,773199,4367,4337,427825,426321,05/05/2022 06:00:11 AM,05/05/2022 07:36:45 AM,05/05/2022 08:15:08 AM
2022/01/12,694,472,11,483,705,715005,657426,57595,715020,773904,4355,4316,432180,430637,05/05/2022 06:00:11 AM,05/05/2022 07:36:45 AM,05/05/2022 08:15:08 AM
2022/01/13,582,430,8,438,590,715587,657856,57603,715458,774494,4053,4016,436233,434653,05/05/2022 06:00:11 AM,05/05/2022 07:36:45 AM,05/05/2022 08:15:08 AM
2022/01/14,687,378,6,384,694,716274,658234,57609,715842,775188,4484,4431,440717,439084,05/05/2022 06:00:11 AM,05/05/2022 07:36:45 AM,05/05/2022 08:15:08 AM
2022/01/15,382,200,1,201,384,716656,658434,57610,716043,775572,2352,2333,443069,441417,05/05/2022 06:00:11 AM,05/05/2022 07:36:45 AM,05/05/2022 08:15:08 AM
2022/01/16,176,94,2,96,178,716832,658528,57612,716139,775750,992,981,444061,442398,05/05/2022 06:00:11 AM,05/05/2022 07:36:45 AM,05/05/2022 08:15:08 AM
2022/01/17,448,219,4,223,453,717280,658747,57616,716362,776203,2861,2830,446922,445228,05/05/2022 06:00:11 AM,05/05/2022 07:36:45 AM,05/05/2022 08:15:08 AM
2022/01/18,509,410,7,417,518,717789,659157,57623,716779,776721,3341,3301,450263,448529,05/05/2022 06:00:11 AM,05/05/2022 07:36:45 AM,05/05/2022 08:15:08 AM
2022/01/19,541,412,6,418,548,718330,659569,57629,717197,777269,3300,3271,453563,451800,05/05/2022 06:00:11 AM,05/05/2022 07:36:45 AM,05/05/2022 08:15:08 AM
2022/01/20,500,385,10,395,513,718830,659954,57639,717592,777782,3076,3023,456639,454823,05/05/2022 06:00:11 AM,05/05/2022 07:36:45 AM,05/05/2022 08:15:08 AM
2022/01/21,519,339,8,347,530,719349,660293,57647,717939,778312,3353,3282,459992,458105,05/05/2022 06:00:11 AM,05/05/2022 07:36:45 AM,05/05/2022 08:15:08 AM
2022/01/22,384,196,4,200,391,719733,660489,57651,718139,778703,1662,1637,461654,459742,05/05/2022 06:00:11 AM,05/05/2022 07:36:45 AM,05/05/2022 08:15:08 AM
2022/01/23,149,86,1,87,150,719882,660575,57652,718226,778853,842,823,462496,460565,05/05/2022 06:00:11 AM,05/05/2022 07:36:45 AM,05/05/2022 08:15:08 AM
2022/01/24,472,326,9,335,482,720354,660901,57661,718561,779335,2781,2711,465277,463276,05/05/2022 06:00:11 AM,05/05/2022 07:36:45 AM,05/05/2022 08:15:08 AM
2022/01/25,469,323,9,332,482,720823,661224,57670,718893,779817,2872,2821,468149,466097,05/05/2022 06:00:11 AM,05/05/2022 07:36:45 AM,05/05/2022 08:15:08 AM
2022/01/26,443,397,8,405,453,721266,661621,57678,719298,780270,2672,2606,470821,468703,05/05/2022 06:00:11 AM,05/05/2022 07:36:45 AM,05/05/2022 08:15:08 AM
2022/01/27,406,375,6,381,415,721672,661996,57684,719679,780685,2543,2468,473364,471171,05/05/2022 06:00:11 AM,05/05/2022 07:36:45 AM,05/05/2022 08:15:08 AM
2022/01/28,481,436,10,446,492,722153,662432,57694,720125,781177,2859,2768,476223,473939,05/05/2022 06:00:11 AM,05/05/2022 07:36:45 AM,05/05/2022 08:15:08 AM
2022/01/29,313,309,7,316,320,722466,662741,57701,720441,781497,1583,1516,477806,475455,05/05/2022 06:00:11 AM,05/05/2022 07:36:45 AM,05/05/2022 08:15:08 AM
2022/01/30,121,126,0,126,121,722587,662867,57701,720567,781618,646,628,478452,476083,05/05/2022 06:00:11 AM,05/05/2022 07:36:45 AM,05/05/2022 08:15:08 AM
2022/01/31,371,311,8,319,380,722958,663178,57709,720886,781998,1970,1873,480422,477956,05/05/2022 06:00:11 AM,05/05/2022 07:36:45 AM,05/05/2022 08:15:08 AM
2022/02/01,289,304,9,313,300,723247,663482,57718,721199,782298,1643,1573,482065,479529,05/05/2022 06:00:11 AM,05/05/2022 07:36:45 AM,05/05/2022 08:15:08 AM
2022/02/02,311,352,13,365,325,723558,663834,57731,721564,782623,1654,1559,483719,481088,05/05/2022 06:00:11 AM,05/05/2022 07:36:45 AM,05/05/2022 08:15:08 AM
2022/02/03,302,289,10,299,315,723860,664123,57741,721863,782938,1561,1484,485280,482572,05/05/2022 06:00:11 AM,05/05/2022 07:36:45 AM,05/05/2022 08:15:08 AM
2022/02/04,415,435,6,441,421,724275,664558,57747,722304,783359,1921,1794,487201,484366,05/05/2022 06:00:11 AM,05/05/2022 07:36:45 AM,05/05/2022 08:15:08 AM
2022/02/05,286,248,2,250,289,724561,664806,57749,722554,783648,871,812,488072,485178,05/05/2022 06:00:11 AM,05/05/2022 07:36:45 AM,05/05/2022 08:15:08 AM
2022/02/06,125,77,0,77,125,724686,664883,57749,722631,783773,515,488,488587,485666,05/05/2022 06:00:11 AM,05/05/2022 07:36:45 AM,05/05/2022 08:15:08 AM
2022/02/07,281,273,10,283,292,724967,665156,57759,722914,784065,1433,1323,490020,486989,05/05/2022 06:00:11 AM,05/05/2022 07:36:45 AM,05/05/2022 08:15:08 AM
2022/02/08,281,240,11,251,295,725248,665396,57770,723165,784360,1266,1186,491286,488175,05/05/2022 06:00:11 AM,05/05/2022 07:36:45 AM,05/05/2022 08:15:08 AM
2022/02/09,273,332,3,335,277,725521,665728,57773,723500,784637,1259,1182,492545,489357,05/05/2022 06:00:11 AM,05/05/2022 07:36:45 AM,05/05/2022 08:15:08 AM
2022/02/10,239,231,7,238,247,725760,665959,57780,723738,784884,1088,1004,493633,490361,05/05/2022 06:00:11 AM,05/05/2022 07:36:45 AM,05/05/2022 08:15:08 AM
2022/02/11,281,311,2,313,285,726041,666270,57782,724051,785169,1418,1302,495051,491663,05/05/2022 06:00:11 AM,05/05/2022 07:36:45 AM,05/05/2022 08:15:08 AM
2022/02/12,200,204,2,206,202,726241,666474,57784,724257,785371,650,604,495701,492267,05/05/2022 06:00:11 AM,05/05/2022 07:36:45 AM,05/05/2022 08:15:08 AM
2022/02/13,98,41,0,41,98,726339,666515,57784,724298,785469,290,270,495991,492537,05/05/2022 06:00:11 AM,05/05/2022 07:36:45 AM,05/05/2022 08:15:08 AM
2022/02/14,166,157,2,159,169,726505,666672,57786,724457,785638,821,733,496812,493270,05/05/2022 06:00:11 AM,05/05/2022 07:36:45 AM,05/05/2022 08:15:08 AM
2022/02/15,157,214,6,220,163,726662,666886,57792,724677,785801,806,723,497618,493993,05/05/2022 06:00:11 AM,05/05/2022 07:36:45 AM,05/05/2022 08:15:08 AM
2022/02/16,186,229,6,235,193,726848,667115,57798,724912,785994,1056,968,498674,494961,05/05/2022 06:00:11 AM,05/05/2022 07:36:45 AM,05/05/2022 08:15:08 AM
2022/02/17,199,216,2,218,203,727047,667331,57800,725130,786197,995,899,499669,495860,05/05/2022 06:00:11 AM,05/05/2022 07:36:45 AM,05/05/2022 08:15:08 AM
2022/02/18,254,280,4,284,258,727301,667611,57804,725414,786455,1194,1059,500863,496919,05/05/2022 06:00:11 AM,05/05/2022 07:36:45 AM,05/05/2022 08:15:08 AM
2022/02/19,152,146,1,147,154,727453,667757,57805,725561,786609,616,571,501479,497490,05/05/2022 06:00:11 AM,05/05/2022 07:36:45 AM,05/05/2022 08:15:08 AM
2022/02/20,75,57,0,57,75,727528,667814,57805,725618,786684,299,260,501778,497750,05/05/2022 06:00:11 AM,05/05/2022 07:36:45 AM,05/05/2022 08:15:08 AM
2022/02/21,105,112,2,114,109,727633,667926,57807,725732,786793,494,439,502272,498189,05/05/2022 06:00:11 AM,05/05/2022 07:36:45 AM,05/05/2022 08:15:08 AM
2022/02/22,154,175,4,179,160,727787,668101,57811,725911,786953,808,717,503080,498906,05/05/2022 06:00:11 AM,05/05/2022 07:36:45 AM,05/05/2022 08:15:08 AM
2022/02/23,156,175,2,177,158,727943,668276,57813,726088,787111,820,741,503900,499647,05/05/2022 06:00:11 AM,05/05/2022 07:36:45 AM,05/05/2022 08:15:08 AM
2022/02/24,220,165,7,172,227,728163,668441,57820,726260,787338,765,689,504665,500336,05/05/2022 06:00:11 AM,05/05/2022 07:36:45 AM,05/05/2022 08:15:08 AM
2022/02/25,270,200,7,207,280,728433,668641,57827,726467,787618,1029,925,505694,501261,05/05/2022 06:00:11 AM,05/05/2022 07:36:45 AM,05/05/2022 08:15:08 AM
2022/02/26,123,108,2,110,125,728556,668749,57829,726577,787743,500,466,506194,501727,05/05/2022 06:00:11 AM,05/05/2022 07:36:45 AM,05/05/2022 08:15:08 AM
2022/02/27,66,50,0,50,66,728622,668799,57829,726627,787809,221,205,506415,501932,05/05/2022 06:00:11 AM,05/05/2022 07:36:45 AM,05/05/2022 08:15:08 AM
2022/02/28,169,134,4,138,173,728791,668933,57833,726765,787982,828,745,507243,502677,05/05/2022 06:00:11 AM,05/05/2022 07:36:45 AM,05/05/2022 08:15:08 AM
2022/03/01,103,101,11,112,115,728894,669034,57844,726877,788097,622,542,507865,503219,05/05/2022 06:00:11 AM,05/05/2022 07:36:45 AM,05/05/2022 08:15:08 AM
2022/03/02,119,120,2,122,121,729013,669154,57846,726999,788218,582,511,508447,503730,05/05/2022 06:00:11 AM,05/05/2022 07:36:45 AM,05/05/2022 08:15:08 AM
2022/03/03,135,82,7,89,142,729148,669236,57853,727088,788360,605,516,509052,504246,05/05/2022 06:00:11 AM,05/05/2022 07:36:45 AM,05/05/2022 08:15:08 AM
2022/03/04,191,173,7,180,199,729339,669409,57860,727268,788559,759,660,509811,504906,05/05/2022 06:00:11 AM,05/05/2022 07:36:45 AM,05/05/2022 08:15:08 AM
2022/03/05,110,95,0,95,111,729449,669504,57860,727363,788670,358,331,510169,505237,05/05/2022 06:00:11 AM,05/05/2022 07:36:45 AM,05/05/2022 08:15:08 AM
2022/03/06,50,41,0,41,50,729499,669545,57860,727404,788720,153,136,510322,505373,05/05/2022 06:00:11 AM,05/05/2022 07:36:45 AM,05/05/2022 08:15:08 AM
2022/03/07,159,93,4,97,165,729658,669638,57864,727501,788885,521,434,510843,505807,05/05/2022 06:00:11 AM,05/05/2022 07:36:45 AM,05/05/2022 08:15:08 AM
2022/03/08,128,84,0,84,128,729786,669722,57864,727585,789013,475,415,511318,506222,05/05/2022 06:00:11 AM,05/05/2022 07:36:45 AM,05/05/2022 08:15:08 AM
2022/03/09,132,103,4,107,136,729918,669825,57868,727692,789149,512,423,511830,506645,05/05/2022 06:00:11 AM,05/05/2022 07:36:45 AM,05/05/2022 08:15:08 AM
2022/03/10,119,134,4,138,123,730037,669959,57872,727830,789272,535,452,512365,507097,05/05/2022 06:00:11 AM,05/05/2022 07:36:45 AM,05/05/2022 08:15:08 AM
2022/03/11,190,148,2,150,193,730227,670107,57874,727980,789465,631,544,512996,507641,05/05/2022 06:00:11 AM,05/05/2022 07:36:45 AM,05/05/2022 08:15:08 AM
2022/03/12,95,84,2,86,97,730322,670191,57876,728066,789562,300,263,513296,507904,05/05/2022 06:00:11 AM,05/05/2022 07:36:45 AM,05/05/2022 08:15:08 AM
2022/03/13,42,33,1,34,43,730364,670224,57877,728100,789605,143,134,513439,508038,05/05/2022 06:00:11 AM,05/05/2022 07:36:45 AM,05/05/2022 08:15:08 AM
2022/03/14,111,77,3,80,114,730475,670301,57880,728180,789719,474,385,513913,508423,05/05/2022 06:00:11 AM,05/05/2022 07:36:45 AM,05/05/2022 08:15:08 AM
2022/03/15,93,85,8,93,101,730568,670386,57888,728273,789820,477,397,514390,508820,05/05/2022 06:00:11 AM,05/05/2022 07:36:45 AM,05/05/2022 08:15:08 AM
2022/03/16,110,83,3,86,113,730678,670469,57891,728359,789933,457,350,514847,509170,05/05/2022 06:00:11 AM,05/05/2022 07:36:45 AM,05/05/2022 08:15:08 AM
2022/03/17,120,105,5,110,125,730798,670574,57896,728469,790058,487,373,515334,509543,05/05/2022 06:00:11 AM,05/05/2022 07:36:45 AM,05/05/2022 08:15:08 AM
2022/03/18,161,139,2,141,164,730959,670713,57898,728610,790222,608,457,515942,510000,05/05/2022 06:00:11 AM,05/05/2022 07:36:45 AM,05/05/2022 08:15:08 AM
2022/03/19,111,73,1,74,111,731070,670786,57899,728684,790333,268,204,516210,510204,05/05/2022 06:00:11 AM,05/05/2022 07:36:45 AM,05/05/2022 08:15:08 AM
2022/03/20,59,28,1,29,60,731129,670814,57900,728713,790393,189,133,516399,510337,05/05/2022 06:00:11 AM,05/05/2022 07:36:45 AM,05/05/2022 08:15:08 AM
2022/03/21,121,79,1,80,123,731250,670893,57901,728793,790516,470,330,516869,510667,05/05/2022 06:00:11 AM,05/05/2022 07:36:45 AM,05/05/2022 08:15:08 AM
2022/03/22,90,55,4,59,94,731340,670948,57905,728852,790610,388,284,517257,510951,05/05/2022 06:00:11 AM,05/05/2022 07:36:45 AM,05/05/2022 08:15:08 AM
2022/03/23,91,88,4,92,96,731431,671036,57909,728944,790706,446,329,517703,511280,05/05/2022 06:00:11 AM,05/05/2022 07:36:45 AM,05/05/2022 08:15:08 AM
2022/03/24,106,77,4,81,111,731537,671113,57913,729025,790817,462,339,518165,511619,05/05/2022 06:00:11 AM,05/05/2022 07:36:45 AM,05/05/2022 08:15:08 AM
2022/03/25,114,97,3,100,118,731651,671210,57916,729125,790935,496,377,518661,511996,05/05/2022 06:00:11 AM,05/05/2022 07:36:45 AM,05/05/2022 08:15:08 AM
2022/03/26,80,63,1,64,81,731731,671273,57917,729189,791016,255,194,518916,512190,05/05/2022 06:00:11 AM,05/05/2022 07:36:45 AM,05/05/2022 08:15:08 AM
2022/03/27,51,27,0,27,51,731782,671300,57917,729216,791067,189,131,519105,512321,05/05/2022 06:00:11 AM,05/05/2022 07:36:45 AM,05/05/2022 08:15:08 AM
2022/03/28,99,92,3,95,102,731881,671392,57920,729311,791169,505,359,519610,512680,05/05/2022 06:00:11 AM,05/05/2022 07:36:45 AM,05/05/2022 08:15:08 AM
2022/03/29,91,65,4,69,95,731972,671457,57924,729380,791264,678,341,520288,513021,05/05/2022 06:00:11 AM,05/05/2022 07:36:45 AM,05/05/2022 08:15:08 AM
2022/03/30,88,86,1,87,89,732060,671543,57925,729467,791353,1267,391,521555,513412,05/05/2022 06:00:11 AM,05/05/2022 07:36:45 AM,05/05/2022 08:15:08 AM
2022/03/31,106,106,3,109,109,732166,671649,57928,729576,791462,1775,499,523330,513911,05/05/2022 06:00:11 AM,05/05/2022 07:36:45 AM,05/05/2022 08:15:08 AM
2022/04/01,128,131,5,136,133,732294,671780,57933,729712,791595,2430,418,525760,514329,05/05/2022 06:00:11 AM,05/05/2022 07:36:45 AM,05/05/2022 08:15:08 AM
2022/04/02,70,61,1,62,71,732364,671841,57934,729774,791666,1101,169,526861,514498,05/05/2022 06:00:11 AM,05/05/2022 07:36:45 AM,05/05/2022 08:15:08 AM
2022/04/03,39,51,0,51,39,732403,671892,57934,729825,791705,704,103,527565,514601,05/05/2022 06:00:11 AM,05/05/2022 07:36:45 AM,05/05/2022 08:15:08 AM
2022/04/04,115,127,2,129,119,732518,672019,57936,729954,791824,2533,349,530098,514950,05/05/2022 06:00:11 AM,05/05/2022 07:36:45 AM,05/05/2022 08:15:08 AM
2022/04/05,84,92,10,102,95,732602,672111,57946,730056,791919,2140,319,532238,515269,05/05/2022 06:00:11 AM,05/05/2022 07:36:45 AM,05/05/2022 08:15:08 AM
2022/04/06,102,100,1,101,103,732704,672211,57947,730157,792022,2068,315,534306,515584,05/05/2022 06:00:11 AM,05/05/2022 07:36:45 AM,05/05/2022 08:15:08 AM
2022/04/07,123,99,3,102,126,732827,672310,57950,730259,792148,2344,339,536650,515923,05/05/2022 06:00:11 AM,05/05/2022 07:36:45 AM,05/05/2022 08:15:08 AM
2022/04/08,111,170,1,171,112,732938,672480,57951,730430,792260,2902,387,539552,516310,05/05/2022 06:00:11 AM,05/05/2022 07:36:45 AM,05/05/2022 08:15:08 AM
2022/04/09,86,51,2,53,88,733024,672531,57953,730483,792348,1455,205,541007,516515,05/05/2022 06:00:11 AM,05/05/2022 07:36:45 AM,05/05/2022 08:15:08 AM
2022/04/10,60,25,0,25,60,733084,672556,57953,730508,792408,633,99,541640,516614,05/05/2022 06:00:11 AM,05/05/2022 07:36:45 AM,05/05/2022 08:15:08 AM
2022/04/11,102,95,2,97,105,733186,672651,57955,730605,792513,2418,255,544058,516869,05/05/2022 06:00:11 AM,05/05/2022 07:36:45 AM,05/05/2022 08:15:08 AM
2022/04/12,130,86,4,90,136,733316,672737,57959,730695,792649,2298,294,546356,517163,05/05/2022 06:00:11 AM,05/05/2022 07:36:45 AM,05/05/2022 08:15:08 AM
2022/04/13,145,93,1,94,146,733461,672830,57960,730789,792795,2286,298,548642,517461,05/05/2022 06:00:11 AM,05/05/2022 07:36:45 AM,05/05/2022 08:15:08 AM
2022/04/14,122,92,1,93,123,733583,672922,57961,730882,792918,2385,351,551027,517812,05/05/2022 06:00:11 AM,05/05/2022 07:36:45 AM,05/05/2022 08:15:08 AM
2022/04/15,158,133,1,134,159,733741,673055,57962,731016,793077,2748,368,553775,518180,05/05/2022 06:00:11 AM,05/05/2022 07:36:45 AM,05/05/2022 08:15:08 AM
2022/04/16,103,68,2,70,105,733844,673123,57964,731086,793182,968,149,554743,518329,05/05/2022 06:00:11 AM,05/05/2022 07:36:45 AM,05/05/2022 08:15:08 AM
2022/04/17,70,16,0,16,70,733914,673139,57964,731102,793252,332,58,555075,518387,05/05/2022 06:00:11 AM,05/05/2022 07:36:45 AM,05/05/2022 08:15:08 AM
2022/04/18,129,91,1,92,130,734043,673230,57965,731194,793382,2392,274,557467,518661,05/05/2022 06:00:11 AM,05/05/2022 07:36:45 AM,05/05/2022 08:15:08 AM
2022/04/19,112,82,4,86,116,734155,673312,57969,731280,793498,2315,265,559782,518926,05/05/2022 06:00:11 AM,05/05/2022 07:36:45 AM,05/05/2022 08:15:08 AM
2022/04/20,115,102,2,104,118,734270,673414,57971,731384,793616,2296,314,562078,519240,05/05/2022 06:00:11 AM,05/05/2022 07:36:45 AM,05/05/2022 08:15:08 AM
2022/04/21,134,78,1,79,135,734404,673492,57972,731463,793751,2136,301,564214,519541,05/05/2022 06:00:11 AM,05/05/2022 07:36:45 AM,05/05/2022 08:15:08 AM
2022/04/22,116,95,4,99,121,734520,673587,57976,731562,793872,2389,305,566603,519846,05/05/2022 06:00:11 AM,05/05/2022 07:36:45 AM,05/05/2022 08:15:08 AM
2022/04/23,72,53,0,53,72,734592,673640,57976,731615,793944,850,146,567453,519992,05/05/2022 06:00:11 AM,05/05/2022 07:36:45 AM,05/05/2022 08:15:08 AM
2022/04/24,36,20,0,20,36,734628,673660,57976,731635,793980,458,75,567911,520067,05/05/2022 06:00:11 AM,05/05/2022 07:36:45 AM,05/05/2022 08:15:08 AM
2022/04/25,87,90,3,93,90,734715,673750,57979,731728,794070,2081,286,569992,520353,05/05/2022 06:00:11 AM,05/05/2022 07:36:45 AM,05/05/2022 08:15:08 AM
2022/04/26,95,107,4,111,98,734810,673857,57983,731839,794168,1966,260,571958,520613,05/05/2022 06:00:11 AM,05/05/2022 07:36:45 AM,05/05/2022 08:15:08 AM
2022/04/27,101,88,3,91,104,734911,673945,57986,731930,794272,1886,267,573844,520880,05/05/2022 06:00:11 AM,05/05/2022 07:36:45 AM,05/05/2022 08:15:08 AM
2022/04/28,106,78,0,78,106,735017,674023,57986,732008,794378,2187,313,576031,521193,05/05/2022 06:00:11 AM,05/05/2022 07:36:45 AM,05/05/2022 08:15:08 AM
2022/04/29,75,71,5,76,80,735092,674094,57991,732084,794458,2103,282,578134,521475,05/05/2022 06:00:11 AM,05/05/2022 07:36:45 AM,05/05/2022 08:15:08 AM
2022/04/30,58,54,2,56,60,735150,674148,57993,732140,794518,902,184,579036,521659,05/05/2022 06:00:11 AM,05/05/2022 07:36:45 AM,05/05/2022 08:15:08 AM
2022/05/01,41,30,0,30,43,735191,674178,57993,732170,794561,479,86,579515,521745,05/05/2022 06:00:11 AM,05/05/2022 07:36:45 AM,05/05/2022 08:15:08 AM
2022/05/02,116,73,1,74,117,735307,674251,57994,732244,794678,1918,241,581433,521986,05/05/2022 06:00:11 AM,05/05/2022 07:36:45 AM,05/05/2022 08:15:08 AM
2022/05/03,100,60,0,60,100,735407,674311,57994,732304,794778,1810,251,583243,522237,05/05/2022 06:00:11 AM,05/05/2022 07:36:45 AM,05/05/2022 08:15:08 AM
2022/05/04,50,69,2,71,52,735457,674380,57996,732375,794830,1578,204,584821,522441,05/05/2022 06:00:11 AM,05/05/2022 07:36:45 AM,05/05/2022 08:15:08 AM
